cost	target-start	target-end	target-length	left-primer-start	left-primer-num-primers	left-primer-frac-bound	left-primer-target-sequences	right-primer-start	right-primer-num-primers	right-primer-frac-bound	right-primer-target-sequences	num-guides	total-frac-bound-by-guides	guide-target-sequences	guide-target-sequence-positions
2.534811090344213	1826	1916	90	1826	1	1.0	AAAACTCTCCTTCCCGAATGGATCAGGATG	1886	1	1.0	AAGGAGAGGCACCACGAAAACAAGAATCAC	1	1.0	CCTTCTTTTTTGAGAGGGATCCTGAGGC	{1856}
2.534811090344213	6446	6536	90	6446	1	1.0	GATAACAATAACCAATGACACCACTGTGAC	6506	1	1.0	TGCTGTCATTGGTACCATAGCACTAGGAGT	1	1.0	ATGACAATCCACAAACTAGATTCTTTGG	{6478}
2.5842266863651715	13404	13499	95	13404	1	1.0	CCTATGTATACTTGGTTCTATCTTCCTGAC	13469	1	1.0	TGCCATACGTATCCCTTATTTTGGTTCTGC	1	1.0	CGACTTAGATACACTTAGCAATGGAAGT	{13439}
2.6237942636811997	6721	6809	88	6721	1	1.0	GACCTGCAATAGGAGAACTAAGGTGTGAGA	6779	1	1.0	CACCCAACACTACTCTGAATTAGCAACAGC	2	1.0	CTACAGCACTGAAACTAGGGATCAAGCT CTACGGCATTGAAACTAGGGATCAAGCT	{6751} {6751}
2.6426729313414405	15477	15579	102	15477	1	1.0	GGGAATGATGAATGTGAAACACTAATCTGG	15549	1	1.0	ATGGAAGGCGGAGAACACAAATGTGATCAG	1	1.0	ATTACAGAATAATTCAATAGGGTTTATT	{15512}
2.6502160284948064	3869	3972	103	3869	1	1.0	ATCTGGCAGCATATCTGATCTCACAGAGTC	3942	1	1.0	ATAGCCAAGTATTACGGCACAGATCAAGAA	1	1.0	AACCAGTTATTCAATCTGTGGATCTGGA	{3899}
2.6564224201679636	8369	8460	91	8369	1	1.0	ACAGGAATTGGCTCAGATATGCGAGAACAC	8430	1	1.0	CCTCTGGACCCACATGATTTCTGGAGATGT	2	1.0	CATTGCCATTCACCATGCAGACGGAATA TATTGCTATTCACCATGCAGACGGAATA	{8399} {8399}
2.676464373321448	9588	9681	93	9588	1	1.0	CATTTCGGAAAGGGCTACTGCTTCCACATT	9651	1	1.0	CAACCTATGTTGTTCAAGACAAGTATCCCT	2	1.0	GTTGAAATCAACCAAATCAGCCTTAATA GTTGAAATCAACCAAGCCAGCCTTAATA	{9618} {9618}
2.678729642842771	13629	13736	107	13629	1	1.0	GCACTTATAGCTCAAACTAGGGCTAACTTA	13706	1	1.0	TTTGTCCCATAGATTGAGAGATACTGCTAC	1	1.0	AGAGAATTTGAAGTTACTCACTCCTGTA	{13664}
2.6920885273623996	13323	13432	109	13323	1	1.0	CCAGACCCGTTAGAATTATTAAGAGGATCA	13402	1	1.0	ACCCTATGTATACTTGGTTCTATCTTCCTG	1	1.0	TGTAAGTTTTGTAGATCAGAAGGAAATA	{13374}
2.7172439250039426	9925	10038	113	9925	1	1.0	GCAAGATTGCTCAACTTCATGTTTTGCTAG	10008	1	1.0	TACAAAATCAGAAATGGAGGTTTATCGCCC	1	1.0	TTATGATTTAAAAGATAACAGTATAATA	{9968}
2.7172439250039426	12904	13017	113	12904	1	1.0	CAGTATTGCAGGAATCACCTAATCCTCTTC	12987	1	1.0	TTTTTGATGGATAGGAAAGCCATATTGCCC	1	1.0	TATCAGGTCTATTTTCAGAATCAAGTAG	{12934}
2.7216894934871645	8430	8528	98	8430	1	1.0	CCTCTGGACCCACATGATTTCTGGAGATGT	8498	1	1.0	CTCATTATTACCTGGACCAAGTCTACTTTC	2	1.0	CCCATAGGAGAACCCCTATTGAGCAACA CCGTAGGGGAACCCCTACTGAGCAACAA	{8460} {8461}
2.7232360029807228	15159	15273	114	15159	1	1.0	CTTTTCGGGATTAATAGCACCAGTTGTTTG	15243	1	1.0	AGATTATATCTCGGAGAAGGTGCAGGTGCA	1	1.0	AAGCATTAGAACTTACTTATTTACTGAA	{15190}
2.751623285568201	15278	15397	119	15278	1	1.0	GTCTTGTTATGATGCTACATTAGGACCCTG	15367	1	1.0	ATATTTATCCTTCAGAAGTGGCACTGGTAG	1	1.0	ATTATTACAATTCAGGTGTTAATTCTTG	{15313}
2.757011090344213	952	1072	120	952	1	1.0	AACGAAGATGGCCGCCTTGACACTATCAAA	1042	1	1.0	CCGAGCCCCTTTTATATGTATACTCAGAGA	1	1.0	TTGTTGATATCTATCTATCAAAGGGAGC	{1014}
2.757011090344213	1826	1946	120	1826	1	1.0	AAAACTCTCCTTCCCGAATGGATCAGGATG	1916	1	1.0	TCTCAGATGTCATCGGACTCCTCGACGTCG	1	1.0	CCTTCTTTTTTGAGAGGGATCCTGAGGC	{1856}
2.7675224201679636	8599	8721	122	8599	1	1.0	CATCAAACTTAATCACTCAAGGATGTGCAG	8691	1	1.0	CCTGATTTAAACCCGGTAATTTCTCATACC	1	1.0	GGTTTTACAATTAGGTTACATATCTTTA	{8648}
2.7726515990016813	6247	6370	123	6247	1	1.0	CAAATGTAGGGGTTATAATCAATGAGGGCA	6340	1	1.0	TTGACTTACAAGATGGATGTGGAACAACTC	1	1.0	ATACATAGTGTTAAGCCTGGTACCTTCC	{6311}
2.7758897580044537	7212	7317	105	7212	1	1.0	ATACCTGACAACCAACAGAAGTGTATACTC	7287	1	1.0	GTACCAAAGTTCGCATTCATAAATGGTGGT	2	1.0	GGAGATGTATCAAAATGCCCTGTGACCA GGGGATGTATCAAAGTGCCCTGTGACCA	{7242} {7242}
