cost	target-start	target-end	target-length	left-primer-start	left-primer-num-primers	left-primer-frac-bound	left-primer-target-sequences	right-primer-start	right-primer-num-primers	right-primer-frac-bound	right-primer-target-sequences	num-guides	total-frac-bound-by-guides	guide-target-sequences	guide-target-sequence-positions
2.5126942636811997	1906	1994	88	1906	1	1.0	CAAGAATCACTCTCAGATGTCATCGGACTC	1964	1	1.0	CCGAAATTGGAGAAGACAGAAGCTGGCTCC	1	1.0	CTCGACGTCGTCCTATCCTACAAGCCCA	{1936}
2.5126942636811997	2432	2520	88	2432	1	1.0	GCATGGAAACTAGCAGCACACATAGTACAA	2490	1	1.0	TCCAGAGCTTGAAGATGCCGTTCTACAAAG	1	1.0	GAATAACTGATGTCATTACCAATCCAAG	{2462}
2.5126942636811997	7074	7162	88	7074	1	1.0	AATATTGAAGGAGAAGAATGGCATGTCGCA	7132	1	1.0	CATCTTTAGGAGGTGCAGATGTCACAAACT	1	1.0	GTCCCAAATTACATAATCAATAAGGCAT	{7104}
2.5126942636811997	8295	8383	88	8295	1	1.0	CAAAGCGGGATCCCAATATTGTTAAACAAG	8353	1	1.0	AGAAGTCATGCAACAAACAGGAATTGGCTC	1	1.0	CAAAGCAGAGATCTCACACAATTAATAG	{8325}
2.5126942636811997	8446	8534	88	8446	1	1.0	ATTTCTGGAGATGTCCCGTAGGAGAACCCC	8504	1	1.0	ATTACCTGGACCAAGTCTACTTTCTGGATC	1	1.0	TACTGAGCAACAATCCCAATATCTCATT	{8476}
2.5126942636811997	9587	9675	88	9587	1	1.0	TCATTTCGGAAAGGGCTACTGCTTCCACAT	9645	1	1.0	ACCTTCCAACCTATGTTGTTCAAGACAAGT	1	1.0	TGTTGAAATCAACCAAGCCAGCCTTAAT	{9617}
2.5126942636811997	13444	13532	88	13444	1	1.0	TAGATACACTTAGCAATGGAAGTCCTGCCA	13502	1	1.0	TGATGAAAGATCAGAGGCTCAACTAGGTTA	1	1.0	TACGTATCCCTTATTTTGGTTCTGCTAC	{13474}
2.5126942636811997	13622	13710	88	13622	1	1.0	GGAAGCAGCACTTATAGCTCAAACTAGGGC	13680	1	1.0	CTCACTCCTGTATCGACTTCTACAAATTTG	1	1.0	TAACTTAAGTTTAGAGAATTTGAAGTTA	{13652}
2.5126942636811997	13707	13795	88	13707	1	1.0	TTGTCCCATAGATTGAGAGATACTGCTACA	13765	1	1.0	TTCGGGCGAGTCGATTTATTACCATATCTA	1	1.0	CAGATGAAGTTTTCAAGTGCTACTTTGG	{13737}
2.534811090344213	6247	6337	90	6247	1	1.0	CAAATGTAGGGGTTATAATCAATGAGGGCA	6307	1	1.0	CTAGATACATAGTGTTAAGCCTGGTACCTT	1	1.0	TTACTTAAGATAGCAGGATCTTATGAAT	{6279}
2.534811090344213	6446	6536	90	6446	1	1.0	GATAACAATAACCAATGACACCACTGTGAC	6506	1	1.0	TGCTGTCATTGGTACCATAGCACTAGGAGT	1	1.0	ATGACAATCCACAAACTAGATTCTTTGG	{6478}
2.534811090344213	7140	7230	90	7140	1	1.0	GGAGGTGCAGATGTCACAAACTGTATAGAA	7200	1	1.0	CCTACACAATTAATACCTGACAACCAACAG	1	1.0	TCAAAATTGGCATATATATGTCCTAGAG	{7170}
2.5453224201679636	15672	15763	91	15672	1	1.0	GGTACAGACTGGACAAAACAATTAAGTCTG	15733	1	1.0	TAGTGTTGAAAACATCTAACCCAGCCTCTA	1	1.0	TTAAGATACTGGAGAGATGTCAGCTTAA	{15705}
2.5842266863651715	12405	12500	95	12405	1	1.0	GTATTTTGGTCAGAGACCCTTGTAGATGAA	12470	1	1.0	AGCCAAAGCTATTGAGAATGGATATTCACC	1	1.0	ATAGGTCAGCATGTTCAAATATTGCAAC	{12436}
2.5842266863651715	13404	13499	95	13404	1	1.0	CCTATGTATACTTGGTTCTATCTTCCTGAC	13469	1	1.0	TGCCATACGTATCCCTTATTTTGGTTCTGC	1	1.0	ACTTAGATACACTGAGCAATGGAAGTCC	{13441}
2.6189163730311917	8622	8721	99	8622	1	1.0	TGTGCAGATATAGGGAAGTCATATCAGGTT	8691	1	1.0	CCTGATTTAAACCCGGTAATTTCTCATACC	1	1.0	TTACAATTAGGTTACATATCTTTAAATT	{8652}
2.6349480554261384	1443	1544	101	1443	1	1.0	CAAATGACAGCAACGAAAGATGGATGAATC	1514	1	1.0	GAACTCGAAGAAGAGACAAATGATGAAGAC	1	1.0	AACCACACAATCACGATTCATGGTGCAG	{1484}
2.6350433771173467	6722	6811	89	6722	1	1.0	ACCTGCAATAGGAGAACTAAGGTGTGAGAC	6781	1	1.0	CCCAACACTACTCTGAATTAGCAACAGCAT	2	1.0	ACGGCACTAAAACTAGGGATCAAGCTCA ACGGCATTGAAACTAGGGATCAAGCTCA	{6753} {6753}
2.6426729313414405	15477	15579	102	15477	1	1.0	GGGAATGATGAATGTGAAACACTAATCTGG	15549	1	1.0	ATGGAAGGCGGAGAACACAAATGTGATCAG	1	1.0	TGAGTTACAGAATAATTCAATAGGGTTT	{15509}
2.6502160284948064	7214	7317	103	7214	1	1.0	ACCTGACAACCAACAGAAGTGTATACTCGG	7287	1	1.0	GTACCAAAGTTCGCATTCATAAATGGTGGT	1	1.0	ATGTATCAAAGTGCCCTGTGACCAAAGT	{7246}
