cost	target-start	target-end	target-length	left-primer-start	left-primer-num-primers	left-primer-frac-bound	left-primer-target-sequences	right-primer-start	right-primer-num-primers	right-primer-frac-bound	right-primer-target-sequences	num-guides	total-frac-bound-by-guides	guide-target-sequences	guide-target-sequence-positions
2.5126942636811997	825	913	88	825	1	0.9968259566214072	ACAGGGAATCTAATTGCTCCTAGGGGTTAC	883	1	0.9952389349321107	TAATGAGATCAGATGCACCCATTGGCAAAT	1	0.9946217598307177	TTCAAAATACGAAGTGGGAAAAGCTCAA	{855}
2.5126942636811997	1616	1704	88	1616	1	0.9997354963851173	CAAAGATTGGATCCTATGGATTTCCTTTGC	1674	1	0.9945335919590901	TTGTTGGGGTTCATCATGTGGGCCTGCCAA	1	0.9985011461823312	CATATCATGTTTTTTGCTTTGTGTTGCT	{1646}
2.6237942636811997	970	1058	88	970	1	0.9911832128372421	ATGTAAACAGGATCACATACGGGGCCTGTC	1028	1	0.9998236642567448	ATTGGCAACAGGAATGCGAAATGTACCAGA	2	0.9986774819255864	CCAGATATGTTAAGCAAAGCACTCTGAA CCAGATATGTTAAGCATAGCACTCTGAA	{1000} {1000}
2.6575857056612073	889	993	104	889	1	0.9921530594251454	GATCAGATGCACCCATTGGCAAATGCAAGT	963	1	0.9992946570269794	TTCCAAAATGTAAACAGGATCACATACGGG	1	0.9999118321283724	CTGAATGCATCACTCCAAATGGAAGCAT	{919}
2.6575857056612073	1021	1125	104	1021	1	0.9923293951684007	CTCTGAAATTGGCAACAGGAATGCGAAATG	1095	1	0.9955916064186211	TTCATAGAAAATGGTTGGGAGGGAATGGTG	1	0.9998236642567448	TACCAGAGAAACAAACTAGAGGCATATT	{1051}
2.7381324226839716	756	856	100	756	1	0.9991183212837242	GATATCCCTAGCAGAATAAGCATCTATTGG	826	1	0.9968259566214072	CAGGGAATCTAATTGCTCCTAGGGGTTACT	2	0.9980603068241932	ACAATAGTAAAACCGGGAGACGTACTTT CCGGGAGACATACTTTTGATTAACAGCA	{786} {798}
2.7971342433258255	1490	1618	128	1490	1	0.9940045847293246	ATACCACAAATGTGACAATGCCTGCATAGG	1588	1	0.997266795979545	TCAAGGGAGTTGAGCTGAAGTCAGGGTACA	1	0.9990301534120967	GGATGAAGCATTAAACAACCGGTTCCAG	{1559}
2.8064266863651715	119	249	130	119	1	0.9905660377358491	GCTGTGCCTTGGGCACCATGCAGTACCAAA	219	1	0.9970022923646623	TCCTCAATAGGTGAAATATGCGACAGTCCT	1	0.9992946570269794	GGAACGATAGTGAAAACAATCACAAATG	{150}
2.8064266863651715	631	726	95	631	1	0.9971786281079175	ACCACCCGGGTACGGACAAGGACCAAATCT	696	1	0.995415270675366	TCTACCAAAAGAAGCCAACAAGCTGTAATC	3	0.995415270675366	TATGCTCAATCATCAGGAAGAATCACAG TATGCTCGATCATCAGGAAGAATCACAG TCCTGTATGCTCAACCATCAGGAAGAAT	{666} {666} {661}
2.8411163730311917	830	968	138	830	1	0.9976194674660553	GAATCTAATTGCTCCTAGGGGTTACTTCAA	938	1	0.9945335919590901	TGGAAGCATTCCCAATGACAAACCATTCCA	1	0.9928584023981661	ACGAAGTGGGAAAAGCTCAATAATGAGA	{863}
2.849232422683972	631	771	140	631	1	0.9971786281079175	ACCACCCGGGTACGGACAAGGACCAAATCT	741	1	0.9903015341209663	AGACCCAGAATAAGGGATATCCCTAGCAGA	1	0.9978839710809381	GTATCTACCAAAAGAAGCCAACAAGCTG	{693}
2.868111090344213	1448	1568	120	1448	1	0.9933874096279316	GAGGGAAAATGCTGAGGATATGGGAAATGG	1538	1	0.9913595485804972	TTATGACCACAATGTGTACAGGGATGAAGC	2	0.9989419855404691	AAATGTGACAATGCCTGCATAAGTTCAA CCTGCATAGAATCAATAAGAAATGAAAC	{1497} {1510}
2.9142885273623995	698	856	158	698	1	0.995415270675366	TACCAAAAGAAGCCAACAAGCTGTAATCCC	826	1	0.9968259566214072	CAGGGAATCTAATTGCTCCTAGGGGTTACT	1	0.9991183212837242	AATAAGGGATATCCCTAGCAGAATAAGC	{749}
2.9142885273623995	1490	1648	158	1490	1	0.9940045847293246	ATACCACAAATGTGACAATGCCTGCATAGG	1618	1	0.9997354963851173	AAGATTGGATCCTATGGATTTCCTTTGCCA	1	0.9990301534120967	GGATGAAGCATTAAACAACCGGTTCCAG	{1559}
2.923954591467449	1202	1363	161	1202	1	0.9970904602362899	AATCGATCAAATCAATGGGAAGCTGAATCG	1333	1	0.9987656497972139	AAATAGATCTCTGGTCATACAACGCGGAGC	1	0.9986774819255864	TCCATCAGATTGAAAAAGAATTCTCAGA	{1258}
2.9454360029807227	830	998	168	830	1	0.9976194674660553	GAATCTAATTGCTCCTAGGGGTTACTTCAA	968	1	0.9925057309116558	AAATGTAAACAGGATCACATACGGGGCCTG	1	0.9928584023981661	ACGAAGTGGGAAAAGCTCAATAATGAGA	{863}
2.9710950406914325	1448	1625	177	1448	1	0.9933874096279316	GAGGGAAAATGCTGAGGATATGGGAAATGG	1595	1	0.9988538176688415	AGTTGAGCTGAAGTCAGGGTACAAAGATTG	1	0.9990301534120967	GGATGAAGCATTAAACAACCGGTTCCAG	{1559}
2.9835160284948063	1373	1519	146	1373	1	0.9977958032093105	CCTGGAGAACCAACATACAATTGATCTAAC	1489	1	0.9952389349321107	TATACCACAAATGTGACAATGCCTGCATAG	2	0.9962087815200141	ACTGTTTGAAAAAACACAGAAGCAACTG CTGAGGGAAAATGCTGAGGATATGGGCA	{1421} {1446}
3.0073265909416214	1202	1393	191	1202	1	0.9970904602362899	AATCGATCAAATCAATGGGAAGCTGAATCG	1363	1	0.999382824898607	TTCTTGTTGCCCTGGAGAACCAACATACAA	1	0.9986774819255864	TCCATCAGATTGAAAAAGAATTCTCAGA	{1258}
3.026328706359163	631	830	199	631	1	0.9971786281079175	ACCACCCGGGTACGGACAAGGACCAAATCT	800	1	0.9955034385469935	GGGAGACATACTTTTGATTAACAGCACAGG	1	0.9978839710809381	GTATCTACCAAAAGAAGCCAACAAGCTG	{693}
