cost	target-start	target-end	target-length	left-primer-start	left-primer-num-primers	left-primer-frac-bound	left-primer-target-sequences	right-primer-start	right-primer-num-primers	right-primer-frac-bound	right-primer-target-sequences	num-guides	total-frac-bound-by-guides	guide-target-sequences	guide-target-sequence-positions
2.5126942636811997	671	759	88	671	1	0.9954064309966048	GCATATGTTTTTGTGGGGACATCAAGATAC	729	1	0.9966047533453165	CAAGACCCAAAGTGAGGGATCAAGAAGGGA	1	0.9968044737367685	AGCAAGAAGTTCAAGCCGGAAATAGCAA	{701}
2.6105894934871645	1621	1719	98	1621	1	0.9950069902137009	CTACCAGATTTTGGCGATCTATTCAACTGT	1689	1	0.9978030756940284	TCAGCTTCTGGATGTGCTCTAATGGGTCTC	1	0.9976033553025764	TTGGTACTGGTAGTCTCCCTGGGGGCAA	{1661}
2.6502160284948064	1261	1364	103	1261	1	0.9968044737367685	CACAGCAGTGGGTAAAGAGTTCAACCACCT	1334	1	0.9982025164769323	TTCCTGGACATTTGGACTTACAATGCCGAA	1	0.9954064309966048	GAATCTAAATAAAAAAGTTGATGATGGT	{1306}
2.6647897580044537	830	935	105	830	1	0.9946075494307969	GTACCGAGATATGCATTCACAATGGAAAGA	905	1	0.9910125823846615	TGCAATACAACTTGTCAGACACCCGAGGGT	1	0.9972039145196725	TCTGGTATTATCATTTCAGATACACCAG	{869}
2.7111377053709504	497	609	112	497	1	0.9966047533453165	GCTGGAGCAAAAAGCTTCTACAAAAACTTG	579	1	0.9932095066906331	TTAATGATAAAGGGAAAGAAGTCCTCGTGC	1	0.9968044737367685	ATGGCTGGTTAAAAAAGGAAATTCATAC	{529}
2.7131405378427527	760	857	97	760	1	0.9904134212103056	AATGAACTATTACTGGACACTAGTAGAGCC	827	1	0.9946075494307969	GTGGTACCGAGATATGCATTCACAATGGAA	2	0.9986019572598362	CAAAATAACATTCGAAGCAACTGGAAAT GAGACAAAATAACATTCGAAGCAACAGG	{796} {792}
2.7675224201679636	1149	1271	122	1149	1	0.9982025164769323	ATCAAAATGAGCAGGGGTCAGGATATGCAG	1241	1	0.9968044737367685	GAAAAGATGAATACACAGTTCACAGCAGTG	1	0.9978030756940284	CCGATCTGAAGAGCACACAAAATGCCAT	{1179}
2.8096648453679434	181	291	110	181	1	0.9948072698222489	GGAAGACAAGCATAACGGAAAACTATGCAA	261	1	0.9978030756940284	GGATCCTGGGAAATCCAGAGTGTGAATCAC	2	0.9986019572598362	CCCCATTGCATTTGGGTAAATGTAACAT GCCCCATTGCATTTGGGCAAATGCAACA	{225} {224}
2.849232422683972	181	321	140	181	1	0.9948072698222489	GGAAGACAAGCATAACGGAAAACTATGCAA	291	1	0.994008388256441	TCTCCACAGCAAGATCATGGTCCTACATTG	1	0.9980027960854804	GATCCTGGGAAATCCAGAGTGTGAATCA	{262}
2.876122044777587	1544	1691	147	1544	1	0.9974036349111244	GACTACCCAAAATACTCAGAGGAAGCAAAA	1661	1	0.9958058717795086	TTGGTACTGGTAGTCTCCCTGGGGGCAATC	1	0.9978030756940284	TACCAGATTTTGGCGATCTATTCAACTG	{1622}
2.9364053540254123	908	1073	165	908	1	0.9910125823846615	AATACAACTTGTCAGACACCCGAGGGTGCT	1043	1	0.9914120231675654	TTGAGGAATGTCCCGTCTATTCAATCTAGA	1	0.9980027960854804	TCCAAAGTATGTAAAAAGCACAAAATTG	{1000}
2.9396435130281846	1034	1169	135	1034	1	0.9910125823846615	GCCACAGGATTGAGGAATGTCCCGTCTATT	1139	1	0.9980027960854804	GGTTATCACCATCAAAATGAGCAGGGGTCA	2	0.9986019572598362	CAATCTAGAGGCCTATTCGGGGCCATTG TTCATTGAAGGGGGGTGGACAGGGGTGG	{1064} {1097}
2.9542192055029934	351	522	171	351	1	0.9962053125624126	GTTACCCAGGAGATTTCATCAATTATGAGG	492	1	0.9926103455162772	CTCACGCTGGAGCAAAAAGCTTCTACAAAA	1	0.9982025164769323	TGTCATCATTTGAAAGGTTTGAAATATT	{405}
2.9683433771173466	497	673	176	497	1	0.9966047533453165	GCTGGAGCAAAAAGCTTCTACAAAAACTTG	643	1	0.9974036349111244	CCAACAAAGTCTCTATCAGAATGCAGATGC	1	0.9968044737367685	ATGGCTGGTTAAAAAAGGAAATTCATAC	{529}
2.9710950406914325	1544	1721	177	1544	1	0.9974036349111244	GACTACCCAAAATACTCAGAGGAAGCAAAA	1691	1	0.9978030756940284	AGCTTCTGGATGTGCTCTAATGGGTCTCTA	1	0.9978030756940284	TACCAGATTTTGGCGATCTATTCAACTG	{1622}
2.9797666660097972	1354	1499	145	1354	1	0.9970041941282205	CAATGCCGAACTGTTGGTTCTACTGGAAAA	1469	1	0.9974036349111244	ATTGGAAACGGCTGCTTTGAATTTTACCAC	2	0.9890153784701418	CTATCACGATTCAAATGTGAAGAATTTG GAACTTGTATGAAAAAGTAAGAACCCAG	{1399} {1420}
2.9818714113224147	120	301	181	120	1	0.9974036349111244	CAGACACTGTAGACACAGTACTAGAAAAGA	271	1	0.9968044737367685	AAATCCAGAGTGTGAATCACTCTCCACAGC	1	0.9966047533453165	ATGTAACAGTAACACACTCTGTTAATCT	{150}
3.0169684256646945	908	1103	195	908	1	0.9910125823846615	AATACAACTTGTCAGACACCCGAGGGTGCT	1073	1	0.9956061513880567	GGCCTATTCGGGGCCATTGCCGGCTTCATT	1	0.9980027960854804	TCCAAAGTATGTAAAAAGCACAAAATTG	{1000}
3.0376573353204814	1477	1681	204	1477	1	0.9972039145196725	CGGCTGCTTTGAATTTTACCACAAATGCGA	1651	1	0.9918114639504694	CGCCAGTTCATTGGTACTGGTAGTCTCCCT	1	0.9978030756940284	TACCAGATTTTGGCGATCTATTCAACTG	{1622}
