cost	target-start	target-end	target-length	left-primer-start	left-primer-num-primers	left-primer-frac-bound	left-primer-target-sequences	right-primer-start	right-primer-num-primers	right-primer-frac-bound	right-primer-target-sequences	num-guides	total-frac-bound-by-guides	guide-target-sequences	guide-target-sequence-positions
2.5126942636811997	1265	1353	88	1265	1	0.9629875886524822	GCTATCTACCGTGTTGGGAGTAGCAGCACT	1323	1	0.9804964539007093	TACTTATGGGATGGACTGCAATCTTCTGAT	1	0.9977836879432624	AGGCATCAAAAACATTGGAAACAAGGAA	{1295}
2.5555	2169	2261	92	2169	1	0.9665336879432624	ATGGCCCATAGATTAAGAATGGATGCACGA	2231	1	0.9909131205673759	TGATTTTGAAAAAGCAATGGCTCACCTTGG	1	0.9988918439716312	CTAGATTATGAATCAGGAAGAATGTCAA	{2199}
2.5932573353204815	1798	1894	96	1798	1	0.9820478723404256	GTGGGCCCAACATTTACAATTTGAGAAACT	1864	1	0.9962322695035462	TGGACCCTGAATACAAAGGGCGGTTACTTC	1	1.0	TACATATCCCAGAAATAGTATTGAAGTA	{1828}
2.6647897580044537	1557	1662	105	1557	1	0.999113475177305	GTTGCTGGAGTAAATGAATCAGCAGATATG	1632	1	0.963209219858156	ATGGGTCCGGCAACAGCACAAACAGCCATA	1	0.999113475177305	GCAATAGGAATGACAATAATAAAGAATA	{1587}
2.704912910986066	329	440	111	329	1	0.9933510638297872	TCAAGCAGCCTCACAGAATGCCATGGAGGC	410	1	0.9968971631205674	TTGGACAGTATGCAGAAACCAGCCTGCTGC	1	0.9997783687943262	CTAATGGTCACAACTGTAGACAAATTAA	{360}
2.7675224201679636	1013	1135	122	1013	1	0.9778368794326241	TTGGTTCCGGGATTTTTGTAGTATAGCACC	1105	1	0.9873670212765957	AAAGACTAAAGGCTCAAATACCTTGTCCTG	1	0.9995567375886525	AAAGGATTCATGATAACAAGTAAAACAA	{1077}
2.792385018119717	1798	1925	127	1798	1	0.9820478723404256	GTGGGCCCAACATTTACAATTTGAGAAACT	1895	1	0.9663120567375887	CCCTCAAAATCCCTTTGTGGGACATTTGTC	1	1.0	TACATATCCCAGAAATAGTATTGAAGTA	{1828}
2.7971342433258255	1897	2025	128	1897	1	0.9694148936170213	CTCAAAATCCCTTTGTGGGACATTTGTCTA	1995	1	0.9625443262411347	GTGTCTGGAACTCATAGCTGGAGAACCAAA	1	0.9964539007092199	AAGAAGCAGATATAACCCCAGCACATGG	{1939}
2.8031885273623995	911	1020	109	911	1	0.9827127659574468	GATCAGCATGACAGTAACAGGAGACAATAC	990	1	0.9804964539007093	AGAATAACCAGAGACAGCCCAATTTGGTTC	2	0.9997783687943262	GAATGAATGCTTAAATCCACGAATCTTT GAATGAATGTTTAAACCCAAGAATCTTT	{947} {947}
2.81987901698314	1997	2130	133	1997	1	0.9625443262411347	GTCTGGAACTCATAGCTGGAGAACCAAAAG	2100	1	0.9858156028368794	CTTTTTGAGGCCTGTTTTAACAGTGCATCA	1	1.0	TGAAGAACAATGCTACGCTAAATGTTGC	{2069}
2.8610337616452868	1634	1777	143	1634	1	0.963209219858156	GGGTCCGGCAACAGCACAAACAGCCATACA	1747	1	0.9756205673758865	AGGAGCTATGGGAAAACACTAAAGGAAGAG	1	0.9977836879432624	GAGGAGATTCCAAAGTGGAAGGAAAAAG	{1705}
2.8797857056612073	2113	2261	148	2113	1	0.9886968085106383	GTTTTAACAGTGCATCATACAGGAAACCAG	2231	1	0.9909131205673759	TGATTTTGAAAAAGCAATGGCTCACCTTGG	1	1.0	CGACTAGATTATGAATCAGGAAGAATGT	{2196}
2.9043219161711367	1112	1267	155	1112	1	0.9831560283687943	AAAGGCTCAAATACCTTGTCCTGATCTGTT	1237	1	0.9995567375886525	CTGGGATGATGATGGGAATGTTTAATATGC	1	0.9980053191489362	TTAGAAAGATATAATGAAGAAACAAGGG	{1152}
2.9265573353204815	2103	2199	96	2103	1	0.9997783687943262	TTTGAGGCCTGTTTTAACAGTGCATCATAC	2169	1	0.9665336879432624	ATGGCCCATAGATTAAGAATGGATGCACGA	4	0.9995567375886525	AGGAAACCAGTAGGGCAACATAGCATGC AGGAAACCAGTAGGGCAGCATAGCATGC AGTAGGGCAACATAGCATGCTTGAGGCT CAGTGGGTCAACATAGCATGCTTGAGGC	{2133} {2133} {2141} {2140}
2.9627681611474057	1634	1808	174	1634	1	0.963209219858156	GGGTCCGGCAACAGCACAAACAGCCATACA	1778	1	0.9771719858156028	TGGTCTGTTAGTAGCAGATGGTGGGCCCAA	1	0.9977836879432624	GAGGAGATTCCAAAGTGGAAGGAAAAAG	{1705}
2.992297268051916	1112	1297	185	1112	1	0.9831560283687943	AAAGGCTCAAATACCTTGTCCTGATCTGTT	1267	1	0.9645390070921985	TATCTACCGTGTTGGGAGTAGCAGCACTAG	1	0.9980053191489362	TTAGAAAGATATAATGAAGAAACAAGGG	{1152}
3.0286266863651714	419	619	200	419	1	0.9922429078014184	ATGCAGAAACCAGCCTGCTGCAACGGCACT	589	1	0.9512411347517731	AATTGCCTGCAAAAAACAGAAAGGGTTTCC	1	0.9922429078014184	CCAAGATATCATTGATTCATTAGACAAG	{521}
3.0398757998013184	1572	1777	205	1572	1	0.9997783687943262	GAATCAGCAGATATGGCAATAGGAATGACA	1747	1	0.9756205673758865	AGGAGCTATGGGAAAACACTAAAGGAAGAG	1	0.9980053191489362	ATGGGTCCGGCAACAGCACAAACAGCCA	{1632}
3.0464405378427526	140	348	208	140	1	0.987145390070922	AGACACCGTGATCAGAACACATGAGTACTC	318	1	0.9957890070921985	CCAGGTCTGTTTCAAGCAGCCTCACAGAAT	1	0.9977836879432624	ACAATGATAGATCCAACAAATGGGCCAT	{210}
3.0793480554261383	911	1135	224	911	1	0.9827127659574468	GATCAGCATGACAGTAACAGGAGACAATAC	1105	1	0.9873670212765957	AAAGACTAAAGGCTCAAATACCTTGTCCTG	1	0.9995567375886525	ACTGAAAGAATAACCAGAGACAGCCCAA	{984}
