cost	target-start	target-end	target-length	left-primer-start	left-primer-num-primers	left-primer-frac-bound	left-primer-target-sequences	right-primer-start	right-primer-num-primers	right-primer-frac-bound	right-primer-target-sequences	num-guides	total-frac-bound-by-guides	guide-target-sequences	guide-target-sequence-positions
4.220289758004454	26751	26991	240	26751	2	0.9285714285714286	CTTTAACATTGCTTATCATGGCAGAGAACG CTTTAATTTTAGCCATGTCAGCTGACAACG	26961	1	0.9464285714285714	TGCTTGCTGCTGTTTACAGAATTAATTGGG	5	0.8214285714285714	AATCTAGTAATAGGTTTCATTTTCCTTG ACAATTTCCGTTGAGGAGCTTAAAAGAC ATTACTGTTGAAGAGCTTAAGCAGCTCT ATTTCTAACATGGATTTGTCTTTTACAG GGACTATTTCCGTCGAGGAGCTTAAAAG	{26825} {26783} {26786} {26845} {26781}
4.33493196905215	26698	26940	242	26698	1	1.0	CTGATCTTCTGGTCTAAACGAACTAACTAT	26910	2	0.9821428571428571	TAAAGCTTGTTTTCCTCTGGCTCTTGTGGC TTAAGTTAATTTTCCTCTGGCTACTTTGGC	6	0.8928571428571429	AATCTAGTAATAGGTTTCATTTTCCTTG ACAATTTCCGTTGAGGAGCTTAAAAGAC ATTACTGTTGAAGAGCTTAAGCAGCTCT GAACTTTAATTTTAGCCATGTCAGCTGA GTGGAATCTAGTAATAGGATTCCTATTT TTATCATGGCTGAGAACGGGACTATTTC	{26825} {26783} {26786} {26748} {26821} {26763}
4.782935466635868	26654	26898	244	26654	1	0.9285714285714286	CGTTTACTCACGTGTTAAAAATCTGAACTC	26868	3	0.9642857142857143	TACAATTTGCCTATGCCAACAGGAATAGGT TACAATTTGCCTATTCTAACCGGAACAGGT TACAGTTCGCCTATGCTAACAGGAATAGGT	4	0.8392857142857143	AATCTAGTAATAGGTTTCATTTTCCTTG ACAATTTCCGTTGAGGAGCTTAAAAGAC GAACTTTAATTTTAGCCATGTCAGCTGA TTATCATGGCTGAGAACGGGACTATTTC	{26825} {26783} {26748} {26763}
4.824240537842753	26698	26906	208	26698	1	1.0	CTGATCTTCTGGTCTAAACGAACTAACTAT	26876	3	0.9285714285714286	GCCTATGCTAACAGGAATAGGTTTCTGTAC GCCTATTCCAACCGGAACAGGTTTCTGTAT GCCTATTCTAATCGGAACAGGTTTTTGTAC	5	0.875	AATCTAGTAATAGGTTTCATTTTCCTTG ACAATTTCCGTTGAGGAGCTTAAAAGAC ATTACTGTTGAAGAGCTTAAGCAGCTCT GAACTTTAATTTTAGCCATGTCAGCTGA TTATCATGGCTGAGAACGGGACTATTTC	{26825} {26783} {26786} {26748} {26763}
4.881601953228442	9298	9535	237	9298	1	0.9107142857142857	GAGGGTTCTGTTAGAGTAGTTACAACTTTT	9505	3	0.9107142857142857	GGTGCTTTAGACATATCAGCTTCAATTGTT GGTGCTTTAGATGTGTCTGCTTCAGTAGTG GGTGCTTTGGACATATCTGCATCTATTGTA	5	0.8035714285714286	ATAGAGCTCTACCTGGAGTATTTTGTGG ATTCAGAGTATTGTAGACATGGTACTTG GAGAGGTCAGAAGCTGGTATTTGCTTGT TACTTGTGAAAGGTCAGAAGTTGGTGTG TGATTATTATAGATCATTACCTGGTGTG	{9422} {9329} {9358} {9351} {9414}
4.891294696155047	26751	26940	189	26751	2	0.9285714285714286	CTTTAACATTGCTTATCATGGCAGAGAACG CTTTAATTTTAGCCATGTCAGCTGACAACG	26910	2	0.9821428571428571	TAAAGCTTGTTTTCCTCTGGCTCTTGTGGC TTAAGTTAATTTTCCTCTGGCTACTTTGGC	6	0.8571428571428571	AATCTAGTAATAGGTTTCATTTTCCTTG ACAATTTCCGTTGAGGAGCTTAAAAGAC ATTACTGTTGAAGAGCTTAAGCAGCTCT ATTTCTAACATGGATTTGTCTTTTACAG GGAACCTAGTAATAGGATTCTTGTTTCT GGACTATTTCCGTCGAGGAGCTTAAAAG	{26825} {26783} {26786} {26845} {26823} {26781}
5.277189493487165	20363	20575	212	20363	2	0.9464285714285714	ACCCAGGAGTCAAATGGAAATTGATTTCTT GCCCAGATCACAAATGGAAACTGACTTCCT	20545	2	0.9464285714285714	TAGAGGATTTTATCCCTATGGATAGCACAG TAGAGGATTTTATTCCTATGGACAGTACAG	9	0.8928571428571429	ACAACGGTATAAATTAGAGGGCTATGCT AGAACGATATAAGCTAGATGGCTATGCT AGATTTTAGTCATGGACAGCTTGGTGGA ATTACATCTATTGATTGGACTTGCTAAG CATCTAATGATAGGTCTTGCCAAGAGAT GCGGACTTCATTTAATGATTGGTCTTGC GGCCAACTTGGTGGACTACATCTAATGA TAAACGTTCAAAGGATTCGCCTCTCGAG TACAACGGTATAAGTTAGAGGGTTATGC	{20417} {20417} {20465} {20492} {20496} {20488} {20478} {20516} {20416}
5.4015942636812	3530	3702	172	3530	2	0.9107142857142857	ACATGGTGGTGGTGTAGCAGGTGCACTCAA ACATGGTGGTGGTGTAGCTGGTGCTCTAAA	3672	3	0.9107142857142857	TGCCTTCATGTTGTTGGTCCTAATCTCAAC TGTATGCATGTTGTTGGCCCAAACCTAAAT TGTCTGCATGTTGTTGGACCTAACCTAAAT	5	0.8392857142857143	AATTGAGTCTGATGACTACATTGCCAGA ACTAATGGTGCTATGCAGAATGAGAGTG CAGTGGGGGGTTCATGTTTGCTTTCTGG CCACTCACAGTAGGTGGTTCATGTTTGC TAGTTGGAGGTTCATGTTTGCTTTCTGG	{3584} {3567} {3625} {3618} {3625}
5.4531010878282045	26751	26904	153	26751	2	0.9285714285714286	CTTTAACATTGCTTATCATGGCAGAGAACG CTTTAATTTTAGCCATGTCAGCTGACAACG	26874	3	0.9642857142857143	TCGCCTATGCTAACAGGAATAGGTTTCTGT TTGCCTATGCCAACAGGAATAGGTTTTTGT TTGCCTATTCTAACCGGAACAGGTTTTTGT	6	0.8571428571428571	AATCTAGTAATAGGTTTCATTTTCCTTG ACAATTTCCGTTGAGGAGCTTAAAAGAC ATTACTGTTGAAGAGCTTAAGCAGCTCT ATTTCTAACATGGATTTGTCTTTTACAG GGAACCTAGTAATAGGATTCTTGTTTCT GGACTATTTCCGTCGAGGAGCTTAAAAG	{26825} {26783} {26786} {26845} {26823} {26781}
5.902630266661922	20363	20612	249	20363	2	0.9464285714285714	ACCCAGGAGTCAAATGGAAATTGATTTCTT GCCCAGATCACAAATGGAAACTGACTTCCT	20582	3	0.9285714285714286	TTACTTCATAACAGATGCACAAACAGGTTC TTACTTTATTACAGATGCACAAACAGGGTC TTATTTCATAACAGATGCTCAGACAGGTTC	8	0.8392857142857143	AGATTTTAGTCATGGACAGCTTGGTGGA ATTACATCTATTGATTGGACTTGCTAAG CATCTAATGATAGGTCTTGCCAAGAGAT GCGGACTTCATTTAATGATTGGTCTTGC GGCCAACTTGGTGGACTACATCTAATGA TAAACGTTCAAAGGATTCGCCTCTCGAG TACAACGGTATAAGTTAGAGGGTTATGC TTTCAGTTATGGACAACTTGGCGGGTTG	{20465} {20492} {20496} {20488} {20478} {20516} {20416} {20468}
5.996403865708118	8649	8888	239	8649	3	0.9285714285714286	AGTAACAACAAAGATAGCACTTAAAGGTGG CATAACTACTAAAATCTCACTCAAGGGTGG CATAACTACTAAGATTTCACTTAAGGGTGG	8858	3	0.9464285714285714	ACGACAATTGCTTTGCTAATAAACACGTTG CAGATACTTGTTTTGCTAACAAACATGCTG CTGATGATTGTTTTGCAAACAAACATGCTG	3	0.8035714285714286	GGTTCAAACTTTTGCTGAAAGTCACACT TAAATTTGTTACAAATTGGTTTAAGTAC TACATTGTCTGCTCATGATGGTTATACA	{8696} {8679} {8772}
6.026428706359162	8649	8848	199	8649	3	0.9285714285714286	AGTAACAACAAAGATAGCACTTAAAGGTGG CATAACTACTAAAATCTCACTCAAGGGTGG CATAACTACTAAGATTTCACTTAAGGGTGG	8818	3	0.9107142857142857	AAAGCCATTCAGGATGGTGTCACTCGTGAC AAAGCTATCCAGGACGGTGTCACTCGTGAC AAAGCTATTGAAGATGGTGTCACACGTGAC	4	0.8214285714285714	GGTTCAAACTTTTGCTGAAAGTCACACT GTACTTGGTTTAAATTCATGCTGAAAGT TAAATTTGTTACAAATTGGTTTAAGTAC TACATTGTCTGCTCATGATGGTTATACA	{8696} {8690} {8679} {8772}
6.119801087828204	19964	20210	246	19964	3	0.9642857142857143	ACTCAACAATTTGGGTGTTGACATTGCTGC ACTCAATAATTTGGGTGTCGACATCGCTGC ACTCAATAATTTGGGTGTCGATATCGCTGC	20180	3	0.9285714285714286	AACAGAAGGTTCAGTTAAAGGTTTAACACC AACGGAAGGTTCAGTCAAGGGTTTAACACC AACTGAGGGTAATGTAAAAGGATTACAACC	4	0.8392857142857143	AGCTTATGTTTCTACAATAGGTGTCTGT CAAGAGAGAAGCACCAGCACATATGTCA GGGACAGGTAGACTTTTTCAGAAATGCT TGGTAGAGTTGAAGGACAGGTTGACTTA	{20030} {20015} {20135} {20123}
6.121519948987032	28574	28821	247	28574	1	0.9464285714285714	CTTTTTAGCCTTTCTGCTATTCCTTGTTCT	28791	5	0.9107142857142857	CATGCCCTATACATTTCTACTCGAAATGGT CATGTCCAATACATTACTATTCGGACTGGT CATGTCCCACTGGTTATCAGCCAGAGTGGA CTTGTCCAATTCACTTCTACTCACGATGGT CTTGTCCTACTGGTTACCAACCAGAATGGA	4	0.875	AATTATGCTCATGATATTTTGGTTTGCT CTCATTGTTTTTGGACTCTTAACATCAG GCGCTGTGTATCTAATACACCTTATGTT TTTTGGTTTTCACTTGAACTCCGGGATA	{28604} {28691} {28753} {28620}
6.170379969342407	8240	8454	214	8240	5	0.9107142857142857	AAGCTGAACTTGCAAAGAATGTGTCTTTAG AGACTGAACTTGCTAAGAATGTGTCTTTAG ATAGCGAGCTGGCAAAGGGTGTAGCTTTAG ATAGTGAGCTAGCAAAGGGTGTGGCTTTAG ATAGTGAGTTGGCTAAGGGTGTTGCTTTGG	8424	1	0.9107142857142857	CAAAGTTGAAAACATGACGCCTAGAGATCT	5	0.8392857142857143	ATGGTGTCTTATCCACATTTGTTTCAGC CTACATTTGTGTCGGCTGCTCGTCAAGG CTTTCAACATTTATCTCAGCAGCTCGTC GTGTCTCAAACTTTCTCACCATTCTGAT TTTCTACATTTGTGTCCGCAGCCCGTCA	{8270} {8282} {8278} {8349} {8279}
6.1944337616452865	7166	7392	226	7166	4	0.9107142857142857	CTCCTTCTTATTGTAGTGGCGTTAGAGAAT TCCCTTCTTATTGTGGTGGTGTTAGAGATT TGCCGTCATACTGTACAAGTTACAGAGATG TTCCTTCTTATTGTGATGGCGTTAGAGAGT	7362	2	0.9821428571428571	AGCTGAGTGGTTTTTGGCATATATGTTGTT TGCAGAGTGGTGTTTGGCATATATTCTCTT	5	0.8214285714285714	CAGTGTTTGTTTAAGTGGATTAGATTCG CAGTGTTTGTTTAGGTGGATTAGACTCT GAGGGTTCTTTCCCATGCAGTGTTTGCT TACTAATGTCACAACAACAGCTTACTGT TATAAGCTAGACCTGACATTTTTGGGTT	{7254} {7254} {7237} {7209} {7330}
6.232619948987033	8088	8335	247	8088	3	0.9107142857142857	CCAACCTATTCTGTTGCTTGACCAAGCTCT TCAACCTATACTGTTACTGGACCAGGCATT TCAACCTATATTGTTACTTGACCAGGCGTT	8305	3	0.9107142857142857	CAAGGGTTTGTTGATTCTGATGTTGATACT CAAGGTGTTGTAGACACTGATGTTGACACA CAAGGTGTTGTTGATACTGATGTTGATACA	5	0.8392857142857143	ATGTTGGTGATAGTACTGAGGTTTCTGT CCTTTCTACATTTGTGTCGGCTGCTCGT CTTGTTGCTACAGCACATAGTGAGTTGG TCAACTTTTAACGTGCCTATGGATAAGT TCCTTTCTACATTTGTGTCCGCATCCCG	{8126} {8277} {8224} {8188} {8276}
6.281479969342406	8125	8339	214	8125	3	0.9107142857142857	GATGTTGGAGATAGTACTGAAGTTTCTGTT GATGTTGGTGACAGTGCAGAAGTAGCTGTT GATGTTGGTGATAGTACCGAGGTTTCTGTC	8309	3	0.9107142857142857	GGTTTGTTGATTCTGATGTTGATACTAAGG GTGTTGTAGACACTGATGTTGACACAAAGG GTGTTGTTGATACTGATGTTGATACAAAGG	6	0.875	ACTAAAAGCACTTGTTGCAACTGCCCAT CCTTTCTACATTTGTGTCGGCTGCTCGT CTTATCCACATTTGTTTCAGCTGCCCGT CTTGTTGCTACAGCACATAGTGAGTTGG TCAACTTTTAACGTGCCTATGGATAAGT TTTCTACATTTGTGTCCGCAGCCCGTCA	{8214} {8277} {8277} {8224} {8188} {8279}
6.343719948987032	23361	23608	247	23361	3	0.9107142857142857	AATGCACCCGCTACAGTCTGTGGACCAAAA AATGCACCTGCTACAGTTTGTGGACCTAAA AATGGACCAGCTACTGTTTGTGGACCCAAA	23578	3	0.9285714285714286	CCTTTGGTGGTGTTAGTGTTATCACACCTG CTTTTGGTGGTGTAAGTGTAATAACACCTG CTTTTGGTGGTGTTAGTGTGATAACACCAG	6	0.8928571428571429	ATGGACTCAAAGGTACTGGTGTTCTGAC CACTGATTCAGTTCGAGATCCGAAGACG TAACGGACTCAAGGGCACTGGTGTCTTG TAATGGACTTAAAGGTACTGGTGTTTTG TACAACACTAGTTAAAGACAAATGTGTC TCCACAGCACTTGTTAAGAACCAGTGTG	{23437} {23522} {23435} {23435} {23396} {23394}
6.501136002980723	6968	7136	168	6968	3	0.9464285714285714	CACTTCCTACGACTATTGCTAAAAATAGTG CTATGCCAACCACTATAGCAAAGAATACTG CTATGCCAACTACTATAGCTAAAAATACGG	7106	4	0.9285714285714286	GCCTAGGTTCTTTAACCTATGTAACTGCTG GCTTAGGTTCACTAATCTATGTAACTGCAG GCTTAGGTTCATTAACCTATGTGACTGCAG GTCTAGGTTCTTTAATCTATTCAAGTGCTG	3	0.8392857142857143	ACGTTTGCATTAATTATGTGAAATCTCC CAAATTTTCTAAATTGTTCACTGTTGCA TTCTAAACTCATAACTATTATAGTATGG	{7025} {7053} {7059}
6.642772931341441	6968	7196	228	6968	3	0.9464285714285714	CACTTCCTACGACTATTGCTAAAAATAGTG CTATGCCAACCACTATAGCAAAGAATACTG CTATGCCAACTACTATAGCTAAAAATACGG	7166	4	0.9107142857142857	CTCCTTCTTATTGTAGTGGCGTTAGAGAAT TCCCTTCTTATTGTGGTGGTGTTAGAGATT TGCCGTCATACTGTACAAGTTACAGAGATG TTCCTTCTTATTGTGATGGCGTTAGAGAGT	3	0.8392857142857143	ACGTTTGCATTAATTATGTGAAATCTCC CAAATTTTCTAAATTGTTCACTGTTGCA TTCTAAACTCATAACTATTATAGTATGG	{7025} {7053} {7059}
6.738232422683972	23813	24033	220	23813	3	0.9464285714285714	AGCTGGCATTTGTGCTAGTTACCATACAGT TGCTGGCATATGTGCAAGTTACCATTCCAT TGCTGGCATTTGTGCTAGCTACCATACAGC	24003	4	0.9107142857142857	GCCGTGGATTGTACTATGTACATCTGCGGT TCAGTAGATTGTACAATGTACATCTGTGGT TCCGTAGACTGTACAATGTACATTTGCGGT TCTGTAGATTGTACTATGTACATCTGCGGT	4	0.8035714285714286	ACCTACAAATTTTTCAATCAGTGTCACG ATAATTCAATTGCCATACCTACTAATTT CTCACTTTTACGGAGTACAGGTCAAAAA CTCTACTTTACGTAGTGTAGGTCAGAAA	{23942} {23926} {23843} {23843}
6.751723285568202	8238	8416	178	8238	5	0.9285714285714286	AGAAGCTGAACTTGCAAAGAATGTGTCTTT TCATAGTGAGCTAGCGAAGGGTGTGGCTTT TCATAGTGAGCTGGCAAAGGGTGTAGCTTT TCATAGTGAGTTGGCTAAGGGTGTTGCTTT TGAGACTGAACTTGCTAAGAATGTGTCTTT	8386	2	0.9464285714285714	ACAGGTGACAGTTGTAACAACTTCATGCTC ACAGGTGACAGTTGTAATAACTATATGCTC	5	0.8392857142857143	CTACATTTGTGTCGGCTGCTCGTCAAGG CTTTCAACATTTATCTCAGCAGCTCGTC GATGGTGTCTTATCCACATTTATTTCAG GTGTCTCAAACTTTCTCACCATTCTGAT TTTCTACATTTGTGTCCGCAGCCCGTCA	{8282} {8278} {8269} {8349} {8279}
6.757111090344213	2984	3164	180	2984	3	0.9107142857142857	ATGGAGTGTGGCTACATTCTATTTGTTTGA GTGGAGTGTAGCTACATTCTACTTGTTTGA GTGGGGTGTTGCAACCTACTACTTGTTTGA	3134	4	0.9642857142857143	TGAATACGGCACAGAGGATGACTATAAAGG TGAATACGGTACAGAAGAAGACTACCAAGG TGAGTATGGTACAGAGGATGATTACCAAGG TGAGTATGGTACTGAATCTGATTACAAAGG	5	0.8392857142857143	AAAACTTTCTTCGCGCATGTACTGCTCT AGAAGAAATTGCTGATGAGACCTGTGAA CCTCCTGATGAGGAAGAAGACTGTGAAG CGAGTCTGGTGAGTATACTTTGTCTTCA GTGATGAGTATGAGGAAGAAGAGGAAGT	{3029} {3104} {3063} {3014} {3085}
6.831453964378334	7225	7392	167	7225	5	0.9107142857142857	ACAGCTTACTGTACGGGTTCTATACCGTGT ATGGACTTCTGTGAGGGCTCTTTTCCTTGT ATGGACTTTTGTCAGGGTTATTTTCCCTGC ATGGATTTCTGTGAAGGTTCTTTTCCTTGC GCAACCTACTGCACTGGTTCTATACCTTGT	7362	2	0.9821428571428571	AGCTGAGTGGTTTTTGGCATATATGTTGTT TGCAGAGTGGTGTTTGGCATATATTCTCTT	6	0.8392857142857143	AGTGTTTGTTTAAGTGGATTAGATTCGC AGTGTTTGTTTAGGTGGATTAGACTCTC CTAGATTCTCTTGATTCTTACCCCGCTT TATAAGCTAGACCTGACATTTTTGGGTT TGGTTTAGATTCTTTGGATACTTACCCA TGTCTTAGTGGTATGGATTCTTTAGATG	{7255} {7255} {7273} {7330} {7269} {7261}
6.895872960526725	8240	8485	245	8240	5	0.9107142857142857	AAGCTGAACTTGCAAAGAATGTGTCTTTAG AGACTGAACTTGCTAAGAATGTGTCTTTAG ATAGCGAGCTGGCAAAGGGTGTAGCTTTAG ATAGTGAGCTAGCAAAGGGTGTGGCTTTAG ATAGTGAGTTGGCTAAGGGTGTTGCTTTGG	8455	2	0.9642857142857143	GGTGCATGTATTGATTGTAATGCAAGGCAT GGTGCTTGTATTGATTGCAGTGCACGTCAT	5	0.8392857142857143	ATGGTGTCTTATCCACATTTGTTTCAGC CTACATTTGTGTCGGCTGCTCGTCAAGG CTTTCAACATTTATCTCAGCAGCTCGTC GTGTCTCAAACTTTCTCACCATTCTGAT TTTCTACATTTGTGTCCGCAGCCCGTCA	{8270} {8282} {8278} {8349} {8279}
7.227270128054922	3577	3702	125	3577	5	0.9107142857142857	CCATGCAAAAAGAGAGCGATGATTACATTA CCATGCAACAGGAGAGTGATGATTACATTA CCATGCAGAAGGAGAGTGATGATTACATCA CTATGCAAATTGAGTCTGATGACTACATTG CTATGCAGAATGAGAGTGATGAATACATCA	3672	3	0.9107142857142857	TGCCTTCATGTTGTTGGTCCTAATCTCAAC TGTATGCATGTTGTTGGCCCAAACCTAAAT TGTCTGCATGTTGTTGGACCTAACCTAAAT	5	0.8392857142857143	CAGTGGGGGGTTCATGTTTGCTTTCTGG CCACTCACAGTAGGTGGTTCATGTTTGC CCAGAAATGGACCACTAAACGTGGGTGG GGCAAAATGGACCTCTTACAGTTGGAGG TAGTTGGAGGTTCATGTTTGCTTTCTGG	{3625} {3618} {3607} {3607} {3625}
7.254264845367944	23873	24033	160	23873	4	0.9464285714285714	AATCATTGCTTACACTATGTCTTTAGGTGC AATTGTGGCCTATACTATGTCATTGGGTGC CATTGTGGCTTATACTATGTCTTTGGGTGC TATTGTGGCTTATACTATGTCACTTGGTGC	24003	4	0.9107142857142857	GCCGTGGATTGTACTATGTACATCTGCGGT TCAGTAGATTGTACAATGTACATCTGTGGT TCCGTAGACTGTACAATGTACATTTGCGGT TCTGTAGATTGTACTATGTACATCTGCGGT	4	0.8035714285714286	ACCTACAAATTTTTCAATCAGTGTCACG ATAATTCAATTGCCATACCTACTAATTT TCAATTGCCATACCAACAAATTTTTCAA TGAAAATTCTGTGGCATATGCTAATAAT	{23942} {23926} {23931} {23903}
7.36667380995394	8208	8339	131	8208	5	0.9107142857142857	GGAAAAACTAAAAGCACTAGTTGCAACTGC GGAAAAACTTAAAGCACTAGTGGCCACTGC GGAAAAACTTAAGGCACTTGTTGCTACAGC GGAGAAACTTAAAGCATTAGTTGCAACTGC GGATAAGTTAAAAACTCTCATTGCAACAGC	8309	3	0.9107142857142857	GGTTTGTTGATTCTGATGTTGATACTAAGG GTGTTGTAGACACTGATGTTGACACAAAGG GTGTTGTTGATACTGATGTTGATACAAAGG	6	0.8571428571428571	ACATAGTGAGTTGGCAAAGGGTGTAGCT CCTTTCTACATTTGTGTCGGCTGCTCGT GATGGTGTCTTATCCACATTTATTTCAG GTCTTTAGATAATGTCCTTTCAACATTT TGTCCTGTCTACATTTGTCTCAGCCGCA TTTCTACATTTGTGTCCGCAGCCCGTCA	{8238} {8277} {8269} {8262} {8274} {8279}
7.381005354025413	7107	7272	165	7107	5	0.9107142857142857	CCTAGGTTCTTTAACCTATGTAACTGCTGT CTTAGGTTCACTAATCTATGTAACTGCAGC CTTAGGTTCTTTAACCTATGTGATTGCAGC CTTGGGTTCATTAATCTATGTGACTGCAGC TCTAGGTTCTTTAATCTATTCAAGTGCTGC	7242	3	0.9107142857142857	TTCTATACCGTGTAGTGTTTGTCTTAGTGG TTCTTTTCCCTGCAGTGTCTGTTTAAGTGG TTCTTTTCCTTGCAGTGTTTGTTTAAGTGG	5	0.7857142857142857	CTTGGTGTATGCCTATCTAGTTTAGGTG GTGTGCTTTTATCTAATTTAGGCATCCC TTAGGTGTATTATTGTCCAACTTTGGAG TTAGGTGTATTATTTTCCAACTATGGAG TTTGATGTCTAATCTAGGTATGCCGTCA	{7138} {7142} {7138} {7138} {7146}
7.394754842851935	19997	20212	215	19997	5	0.9285714285714286	CACTGTCATCTGGGACTACAAAAGAGAAGC TACGGTGATTTGGGACTACAAAAGAGAAGC TACTGTAATCTGGGACCACAAGAGAGAAGC TACTGTGGTCTGGGACTACAAGAGAGAAGC TACTGTTATCTGGGACTACAAAAGAGAAGC	20182	3	0.9107142857142857	CAGAAGGTTCAGTCAAGGGTTTAACACCAT CAGAAGGTTCAGTTAAAGGTTTAACACCTT CTGAGGGTAATGTAAAAGGATTACAACCAT	4	0.8392857142857143	ACCAGCGCATATGTCAACAATAGGTGTC AGCTTATGTTTCTACAATAGGTGTCTGT GGGACAGGTAGACTTTTTCAGAAATGCT TGGTAGAGTTGAAGGACAGGTTGACTTA	{20027} {20030} {20135} {20123}
7.4264714113224155	9328	9509	181	9328	5	0.9107142857142857	GACTCTGAGTACTGTAGACATGGTACTTGT GATGCAGAGTACTGCCGTCATGGCACATGT GATGCTGAGTACTGTAGACATGGTACATGC GATGCTGAGTATTGCAGACATGGTACTTGT GATTCAGAGTATTGTAGACATGGTACTTGC	9479	3	0.9107142857142857	TCTTTACACCTCTTGTTCAACCTGTGGGTG TCTTTACTCCCCTTGTGCAACCTGTGGGTG TGTTTACACCTTTGATTCAACCTATTGGTG	5	0.8035714285714286	ATAGAGCTCTACCTGGAGTATTTTGTGG GAAAGGTCAGAAGTTGGTGTGTGCTTAT GAGAGGTCAGAAGCTGGTATTTGCTTGT TGATTATTATAGATCATTACCTGGTGTG TTGCTTGTCTACTAGCGGTAGGTGGGTT	{9422} {9358} {9358} {9414} {9378}
7.535466666009797	3577	3807	230	3577	5	0.9107142857142857	CCATGCAAAAAGAGAGCGATGATTACATTA CCATGCAACAGGAGAGTGATGATTACATTA CCATGCAGAAGGAGAGTGATGATTACATCA CTATGCAAATTGAGTCTGATGACTACATTG CTATGCAGAATGAGAGTGATGAATACATCA	3777	3	0.9107142857142857	CTCTCAGCAGGCATCTTTGGTGCACAACCA TTATCAGCTGGTATTTTTGGTGCTGATCCT TTGTCAGCAGGCATATTTGGTGCTAAACCA	5	0.8035714285714286	AACGAAATGGACCACTCACAGTAGGTGG CAGTGGGGGGTTCATGTTTGCTTTCTGG CCAGAAATGGACCACTAAACGTGGGTGG TAGTTGGAGGTTCATGTTTGCTTTCTGG TATGAGAATTTCAATTCACAGGATGTAT	{3607} {3625} {3607} {3625} {3735}
7.548401953228442	9328	9565	237	9328	5	0.9107142857142857	GACTCTGAGTACTGTAGACATGGTACTTGT GATGCAGAGTACTGCCGTCATGGCACATGT GATGCTGAGTACTGTAGACATGGTACATGC GATGCTGAGTATTGCAGACATGGTACTTGT GATTCAGAGTATTGTAGACATGGTACTTGC	9535	3	0.9107142857142857	GCAGGTGGTTTAGTTGCTATATTTGTAACT GCCGGCGGTATTGTTGCTATCGTAGTAACA GCTGGTGGTATTATTGCCATATTGGTGACT	5	0.8035714285714286	ATAGAGCTCTACCTGGAGTATTTTGTGG GAAAGGTCAGAAGTTGGTGTGTGCTTAT GAGAGGTCAGAAGCTGGTATTTGCTTGT TGATTATTATAGATCATTACCTGGTGTG TTGCTTGTCTACTAGCGGTAGGTGGGTT	{9422} {9358} {9358} {9414} {9378}
7.788219948987033	23592	23839	247	23592	5	0.9464285714285714	AGTGTAATAACACCTGGAACAAATGCTTCA AGTGTAATTACACCAGGAACAAATGCTTCT AGTGTCATAACACCAGGAACTAACACTTCA AGTGTGATAACACCAGGTACAAACACTTCT AGTGTTATCACACCTGGAACGAACGCCTCA	23809	3	0.9285714285714286	TCGGTGCTGGCATATGTGCAAGTTACCATT TTGGTGCAGGAATATGCGCCAGTTATCAGA TTGGTGCTGGCATTTGTGCTAGCTACCATA	7	0.8035714285714286	AAACTGCACTGATGTTCCCACGGCCATA AACATGTTAACGCTTCGTATGAGTGTGA CAATGCTTCTTATGAGTGTGACATCCCA GATGTTAACTGTACTGAAGTGCCTATGG GCAGATCAATTAACACCTGCTTGGCGCG GCAGTGGCTGTTCTTTACCAAGATGTAA TGCTATTCATGCAGATCAATTAACACCA	{23651} {23773} {23780} {23646} {23682} {23625} {23672}
8.014785018119717	24003	24197	194	24003	4	0.9107142857142857	GCCGTGGATTGTACTATGTACATCTGCGGT TCAGTAGATTGTACAATGTACATCTGTGGT TCCGTAGACTGTACAATGTACATTTGCGGT TCTGTAGATTGTACTATGTACATCTGCGGT	24167	5	0.9464285714285714	CAAAACACCACCTATTAAAGATTTTGGTGG CAAAACCCCAACTTTGAAAGATTTTGGTGG CAAGACACCAGCCATAAAGGATTTTGGCGG TAAAACACCAACCATAAGAGATTTTGGTGG TAAGACACCAGCCATAAAAGATTTTGGTGG	4	0.8035714285714286	AGAGGTCTTTGCCCAAGTTAAACAAATG CACAAGAAGTTTTTGCCCAGGTTAAACA CTGGCATTGCTATAGAACAGGACAAAAA GACTCTATAGAGTGTAGCAACTTGTTGT	{24137} {24133} {24103} {24033}
8.053073533078033	7225	7436	211	7225	5	0.9107142857142857	ACAGCTTACTGTACGGGTTCTATACCGTGT ATGGACTTCTGTGAGGGCTCTTTTCCTTGT ATGGACTTTTGTCAGGGTTATTTTCCCTGC ATGGATTTCTGTGAAGGTTCTTTTCCTTGC GCAACCTACTGCACTGGTTCTATACCTTGT	7406	4	0.9107142857142857	ACTTACTTGGTCTCTCCGCCATAATGCAAG ACTTACTTGGTCTCTCTGCTATAATGCAGG ATGTACTAGGTTTAGCCGCAATTATGCAAT ATTTACTAGGTCTTTCAGCTATAATGCAGG	4	0.7678571428571429	AGTGTTTGTTTAAGTGGATTAGATTCGC AGTGTTTGTTTAGGTGGATTAGACTCTC TATAAGCTAGACCTGACATTTTTGGGTT TGTCTTAGTGGTATGGATTCTTTAGATG	{7255} {7255} {7330} {7261}
8.109389758004454	3015	3165	150	3015	5	0.9285714285714286	GACGCTGGTGAAGAAAAACTTTCATCACGC GAGTCCGGTGAATTTAAATTGTCTTCACAT GAGTCTGGTGAGTATACTTTGTCTTCACGT GATGCTGGTGAAGAAAAACTTTCTTCACGT GATGCTGGTGAAGAAAACCTTTCATCGCGT	3135	4	0.9107142857142857	GAATACGGTACAGAAGAAGACTACCAAGGT GAATATGGCACAGAGGATGACTATAAAGGT GAGTATGGTACAGAGGATGATTATCAAGGT GAGTATGGTACTGAATCTGATTACAAAGGT	6	0.8214285714285714	AAGAAGAATACAGCGAAGAGGAACAACC CCTCCTGATGAGGAAGAAGACTGTGAAG GCAGGGTGTGAGGAGGAGGAAATCGCTG GTGATGAGTATGAGGAAGAAGAGGAAGT TCCTGATGAGGAAGAAGAATGTGAAGAG TGAAGAGTATGAGGATGAGGAAGAAATT	{3088} {3063} {3090} {3085} {3065} {3086}
8.121619948987032	19997	20244	247	19997	5	0.9285714285714286	CACTGTCATCTGGGACTACAAAAGAGAAGC TACGGTGATTTGGGACTACAAAAGAGAAGC TACTGTAATCTGGGACCACAAGAGAGAAGC TACTGTGGTCTGGGACTACAAGAGAGAAGC TACTGTTATCTGGGACTACAAAAGAGAAGC	20214	4	0.9285714285714286	AAAGGACCTGTGCAAGCAAGTGTCAATGGA AAGGGACCAGCACAAGCTAGTGTCAATGGA AAGGGACCTATACAAGCTAGTGTCAATGGA GTAGGTCCAAAACAAGCTAGTCTTAATGGA	4	0.8392857142857143	ACCAGCGCATATGTCAACAATAGGTGTC AGCTTATGTTTCTACAATAGGTGTCTGT GGGACAGGTAGACTTTTTCAGAAATGCT TGGTAGAGTTGAAGGACAGGTTGACTTA	{20027} {20030} {20135} {20123}
