cost	target-start	target-end	target-length	left-primer-start	left-primer-num-primers	left-primer-frac-bound	left-primer-target-sequences	right-primer-start	right-primer-num-primers	right-primer-frac-bound	right-primer-target-sequences	num-guides	total-frac-bound-by-guides	guide-target-sequences	guide-target-sequence-positions
2.5453224201679636	30650	30741	91	30650	1	0.996969696969697	GACATGGATGATTTCTCCAGACAACTTCAA	30711	1	0.996969696969697	CTCAGGCATAAACACTCATGATGACCACAC	1	1.0	TCCATGAGTGGAGCTTCTGCTGATTCAA	{30683}
2.923954591467449	30580	30741	161	30580	1	0.996969696969697	GACTGATGAAGCTCAGCCTTTGCCGCAGAG	30711	1	0.996969696969697	CTCAGGCATAAACACTCATGATGACCACAC	1	1.0	TCCATGAGTGGAGCTTCTGCTGATTCAA	{30683}
2.930240417140111	27122	27285	163	27122	1	0.996969696969697	CAGACCGCTCATGGAAAGTGAACTTGTCAT	27255	1	1.0	ACGCTTTCTTATTACAAATTAGGAGCGTCG	1	0.996969696969697	CATTCGTGGTCACTTGCGAATGGCCGGA	{27164}
3.0398757998013184	30536	30741	205	30536	1	0.996969696969697	AAAACATTCCCACCAACAGAGCCTAAAAAG	30711	1	0.996969696969697	CTCAGGCATAAACACTCATGATGACCACAC	1	1.0	TCCATGAGTGGAGCTTCTGCTGATTCAA	{30683}
3.04426719502264	27122	27329	207	27122	1	0.996969696969697	CAGACCGCTCATGGAAAGTGAACTTGTCAT	27299	1	1.0	TGATTCAGGTTTTGCTGCATACAACCGCTA	1	0.996969696969697	CATTCGTGGTCACTTGCGAATGGCCGGA	{27164}
3.146523411032158	1156	1359	203	1156	1	1.0	GTCAAAGTCATTCAACCACGTGTTGAAAAG	1329	1	0.996969696969697	AGCCACTTGTGAACATTGTGGCACTGAAAA	2	0.9878787878787879	AAAAATACTGAAGGTTTCATGGGGCGTA GTTTCATGGCAGACGTGCGACTTTCTGA	{1186} {1300}
3.2120224201679632	26568	26659	91	26568	1	1.0	TTGTGTGCGTACTGCTGCAATATTGTTAAC	26629	2	0.996969696969697	ACTCACGTGTCAAAAATCTGAACTCTGCTG ACTCGCGTGTTAAAAATCTGAACTCTTCTG	1	0.996969696969697	GTGAGTTTAGTAAAACCAACGGTTTACG	{26598}
3.4444	27122	27246	124	27122	1	0.996969696969697	CAGACCGCTCATGGAAAGTGAACTTGTCAT	27216	2	0.996969696969697	AAGGACCTGCCAAAAGAGATCACTGTGGCT AAGGACCTGCCAAAAGAGATTACGGTGGCT	1	0.996969696969697	CATTCGTGGTCACTTGCGAATGGCCGGA	{27164}
3.4632786676602407	1495	1603	108	1495	1	1.0	ATTGAAACTCGACTCCGCAAGGGAGGTAGG	1573	2	1.0	AAGCGAGCCTACTGGGTCCCTCGTGCTAGT AAGCGTGCCTACTGGGTTCCTCGTGCTAGT	2	0.990909090909091	ACTAAGTGTTTTGGAGGCTGTGTATTTT CTAGATGTTTTGGAGGCTGTGTGTTTGC	{1525} {1526}
3.596940417140111	11569	11732	163	11569	1	0.996969696969697	CTAGAGCTATAGTGTTTGTGTGTGTTGAGT	11702	2	1.0	TACTCAACCGCTACTTTAGACTTACTCTTG TACTCAACCGTTACTTCAGGCTTACTCTTG	1	1.0	CTTACAGTGTATCATGCTTGTTTATTGT	{11630}
3.6907141342961087	11534	11732	198	11534	1	1.0	CTATTCTGGTGTCGTTACGACTATCATGTT	11702	2	1.0	TACTCAACCGCTACTTTAGACTTACTCTTG TACTCAACCGTTACTTCAGGCTTACTCTTG	1	1.0	TAGCTAGAGCTATAGTGTTTGTGTGTGT	{11566}
3.6907141342961087	26461	26659	198	26461	1	1.0	CATTCGTTTCGGAAGAAACAGGTACGTTAA	26629	2	0.996969696969697	ACTCACGTGTCAAAAATCTGAACTCTGCTG ACTCGCGTGTTAAAAATCTGAACTCTTCTG	1	0.996969696969697	TTAACGTGAGTTTAGTAAAACCAACGGT	{26593}
3.7741038657081174	26568	26807	239	26568	1	1.0	TTGTGTGCGTACTGCTGCAATATTGTTAAC	26777	2	0.996969696969697	ACTCCTGGAACAATGGAACCTAGTAATAGG GCTCTTGGAACAATGGAACCTAGTAATAGG	1	0.996969696969697	GTGAGTTTAGTAAAACCAACGGTTTACG	{26598}
3.89053196905215	1156	1398	242	1156	1	1.0	GTCAAAGTCATTCAACCACGTGTTGAAAAG	1368	2	0.996969696969697	TGAAGGACCCACTACATGTGGATACCTACC TGAAGGACCTACTACATGTGGGTACCTACC	2	0.9878787878787879	AAAAATACTGAAGGTTTCATGGGGCGTA GTTTCATGGCAGACGTGCGACTTTCTGA	{1186} {1300}
3.8922885040667143	507	750	243	507	2	0.996969696969697	ACAGCCCTATGTGTTCATTAAACGTTCTGA AGAGCCCTATGTGTTCATTAAACGATCTGA	720	1	1.0	TGGCATCGATCTAAAGTCTTATGACTTAGG	2	0.996969696969697	CACAAGGTTGTGGAATTGGTTGCAGAAT CACTGGGAGTACTCGTGCCACATGTGGG	{559} {620}
4.010319948987033	27147	27394	247	27147	2	0.996969696969697	GTCATAGGCGCTGTGATCATTCGTGGTCAC GTCATTGGTGCTGTGATCATTCGTGGTCAC	27364	1	1.0	CCGGTAGCAACGACAATATTGCTTTGCTAG	3	1.0	GCGAATGGCCGGACACTCCCTAGGGCGC GCGGATGGCTGGACACTCCCTTGGGCGC TGCGAATGGCCGGACACCCGCTTGGGCG	{27179} {27179} {27178}
4.068294263681199	11534	11650	116	11534	1	1.0	CTATTCTGGTGTCGTTACGACTATCATGTT	11620	3	0.996969696969697	CTGGCAACACCTTACAGTGTATCATGCTTG CTGGCAACACTTTACAGTGTATTATGCTTG CTGGTAACACTTTACAGTGTATCATGCTTG	1	1.0	TAGCTAGAGCTATAGTGTTTGTGTGTGT	{11566}
4.1111	1329	1421	92	1329	1	0.996969696969697	AGCCACTTGTGAACATTGTGGCACTGAAAA	1391	3	0.996969696969697	ACCTACCTACTAATGCTGTAGTAAAGATGC ACCTACCTACTAATGCTGTAGTGAAAATGC ACCTACCTGCTAATGCTGTAGTAAAAATGC	3	0.9878787878787879	AGTCACTGAAGGACCTACTACATGTGGG AGTTATTGAAGGACCTACTACATGTGGG GTTTGTGAAGGACCCACTACATGTGGAT	{1362} {1362} {1363}
4.120964373321449	30062	30188	126	30062	3	0.996969696969697	AGGGGAAATTCTCCTGCTCGAATGGCTAGC AGGGGAACTTCTCCTGCTCGAATTGCTAGT AGGGGAAGTTCTCCTGCTCGATTGGCTAGC	30158	1	0.996969696969697	TCTGGTAAAGGCCAACAACAACAAGGCCAA	1	1.0	GGAGGTGGTGAAACTGCCCTCGCGCTAT	{30092}
4.157640537842753	27051	27148	97	27051	3	0.996969696969697	CGCTCAATGTGGTCATTCAACCCAGAAACA CGCTCGATGTGGTCATTCAATCCAGAAACA CGTTCTATGTGGTCATTCAATCCAGAAACT	27118	1	0.996969696969697	TGACCAGACCGCTCATGGAAAGTGAACTTG	3	0.9939393939393939	CATTCTTCTCAATGTGCCTCTCCGGGGG CATTCTTCTCAATGTGCCTCTTCGGGGG CTTCTCAATGTGCCTCTCCGAGGAACAA	{27083} {27083} {27087}
4.202066666009798	26778	26923	145	26778	2	0.996969696969697	CTCCTGGAACAATGGAACCTAGTAATAGGT CTCTTGGAACAATGGAACCTAGTAATAGGA	26893	2	0.996969696969697	TCTGGCTCTTGTGGCCAGTAACACTTGCTT TCTGGCTTTTATGGCCAGTAACACTTGCTT	1	0.9939393939393939	GCCTGGATTATGTTACTACAATTTGCCT	{26820}
4.231964373321448	342	534	192	342	1	1.0	GAAAACACACGTCCAACTCAGTTTGCCTGT	504	2	0.996969696969697	TGAACAGCCCTATGTGTTCATTAAACGTTC TGAAGAGCCCTATGTGTTCATTAAACGATC	6	0.9878787878787879	AGAGCTGGAAAAAGGTGTGTTGCCCCAG GACGTGTTAGTGCGTGGTTTCGGGGATA GAGCTGGAAAAGGGCGTATTGCCCCAGC GAGCTGGAGAAAGGCGTTTTGCCCCAGC GGAGCTGGAAAAAGGCGTACTGCCCCAG TGTGGCTTAGTGGAGCTGGAGAAGGGCG	{474} {385} {475} {475} {474} {463}
4.3149468288076465	303	534	231	303	1	0.996969696969697	GAAAGGTAAGATGGAGAGCCTTGTTCTTGG	504	2	0.996969696969697	TGAACAGCCCTATGTGTTCATTAAACGTTC TGAAGAGCCCTATGTGTTCATTAAACGATC	6	0.9878787878787879	AGAGCTGGAAAAAGGTGTGTTGCCCCAG GACGTGTTAGTGCGTGGTTTCGGGGATA GAGCTGGAAAAGGGCGTATTGCCCCAGC GAGCTGGAGAAAGGCGTTTTGCCCCAGC GGAGCTGGAAAAAGGCGTACTGCCCCAG TGTGGCTTAGTGGAGCTGGAGAAGGGCG	{474} {385} {475} {475} {474} {463}
4.343164373321448	1331	1523	192	1331	3	0.996969696969697	CCACTTGTGAACAATGTGGCACTGAAAACG CCACTTGTGAACATTGTGGCACTGAAAATT CCACTTGTGAATATTGTGGCACTGAAAATC	1493	1	0.996969696969697	ACATTGAAACTCGACTCCGCAAGGGAGGTA	1	1.0	CTACATGTGGGTACCTACCTACTAATGC	{1379}
4.37547901698314	26919	27052	133	26919	2	0.996969696969697	GCTTGCTTTGTGCTTGCTGCTGTTTACAGA GCTTGTTTTGTGCTTGCTGCTGTCTACAGA	27022	2	0.996969696969697	TTGCTTCCTTCAGGCTGTTTGCTCGTACCC TTGCTTCTTTCAGGCTGTTTGCTCGCACCC	3	0.9878787878787879	ATCAATTGGGTGACTGGCGGTATTGCGA TCAATTGGGTGACTGGTGGGATTGCGAT TTAATTGGGTGACTGGCGGGATTGCGAT	{26949} {26950} {26950}
4.390491578646308	27073	27286	213	27073	3	0.996969696969697	CAGAAACAAACATTCTTCTCAATGTGCCTC CAGAAACAAATATCCTTCTCAATGTGCCTC CGGAAACAAACATTCTTCCCAATGTGCCTC	27256	1	1.0	CGCTTTCTTATTACAAATTAGGAGCGTCGC	1	0.996969696969697	CATTCGTGGTCACTTGCGAATGGCCGGA	{27164}
4.408814670640964	1381	1603	222	1381	2	1.0	ACATGTGGGTACCTACCTACTAATGCTGTA ACGTGTGGATACCTACCTGCTAATGCTGTA	1573	2	1.0	AAGCGAGCCTACTGGGTCCCTCGTGCTAGT AAGCGTGCCTACTGGGTTCCTCGTGCTAGT	1	1.0	ACATTGAAACTCGACTCCGCAAGGGAGG	{1493}
4.418323285568201	26629	26807	178	26629	2	0.996969696969697	ACTCACGTGTCAAAAATCTGAACTCTGCTG ACTCGCGTGTTAAAAATCTGAACTCTTCTG	26777	2	0.996969696969697	ACTCCTGGAACAATGGAACCTAGTAATAGG GCTCTTGGAACAATGGAACCTAGTAATAGG	2	0.996969696969697	AACTTTAACATTGCTTATCATGGCTGAG ATTCTGTTTGGAACTTTAACATTGCTTA	{26717} {26706}
4.442589758004454	30053	30293	240	30053	1	0.996969696969697	GGCAGCAGTAGGGGAAATTCTCCTGCTCGA	30263	3	0.996969696969697	GTCACCCAAGCTTTTGGGCGACGTGGTCCA GTCACTCAAGCATTTGGGAGACGTGGTCCA GTCACTCAAGCTTTTGGGAGACGCGGTCCA	1	1.0	AGCGGAGGTGGTGAAACTGCCCTCGCGC	{30089}
4.449635466635868	11569	11813	244	11569	1	0.996969696969697	CTAGAGCTATAGTGTTTGTGTGTGTTGAGT	11783	3	0.996969696969697	CAAGGGCTTTTGCCACCTAAGAGTAGTATT CAGGGGCTCCTGCCACCTAAGAGTAGTATT CAGGGGCTTTTGCCTCCTAAGAGTAGTATT	1	1.0	CTTACAGTGTATCATGCTTGTTTATTGT	{11630}
4.486579016983139	1182	1315	133	1182	2	0.996969696969697	AAAGAAAAAGACTGAAGGTTTCATGGGGCG AAAGAAAAAGACTGAGGGTTTCATGGGGCG	1285	2	0.996969696969697	AATCATTGCGATGAAGTTTCATGGCAGACG AATCATTGTGATGAAGCTTCTTGGCAGACG	4	0.996969696969697	ACCCTGTTGCATCTCCACAGGAGTGTAA ATGAATGCAACGACATGCACTTGTCTGT TATGCACTTGTCTACCTTGATGAAATGT TGTACCCTGTTGCCACTCCTCAAGAGTG	{1226} {1244} {1257} {1223}
4.493099245246692	26073	26282	209	26073	3	0.996969696969697	GACTACCAAATAGGTGGTTATTCTGAAGAC GACTACCAAATTGGTGGTTATTCCGAGTAT GACTACCAAATTGGTGGTTATTCTGAGGAT	26252	1	1.0	TGTGCAAATACACACAATCGACGGCTCTTC	2	0.996969696969697	GCATTCAGGTGTAAAAGACTATGTAGTA TCACCGAAGTTTACTACCAGCTTGAGTC	{26105} {26146}
4.553689758004453	1119	1359	240	1119	3	0.996969696969697	GGAATGCCCAAAGTTTGTATTTCCTCTCAA GGAATGCCCAAAGTTTGTGTTTCCTCTTAA GGAATGCCCGAAGTTCGTATTTCCTCTCAA	1329	1	0.996969696969697	AGCCACTTGTGAACATTGTGGCACTGAAAA	2	0.9878787878787879	AAAAATACTGAAGGTTTCATGGGGCGTA GTTTCATGGCAGACGTGCGACTTTCTGA	{1186} {1300}
4.560470128054923	5702	5892	190	5702	1	0.996969696969697	TCTTTTGTTATGATGTCTGCACCACCTGCT	5862	3	0.996969696969697	TGTCAGAATATAAAGGACCAGTGACTGATG TGTCAGAGTACAAAGGACCAGTGACTGATG TGTCAGAGTATAAAGGACCAGTGACTGATG	3	0.9878787878787879	CCTCTATCGTATAGATGGAGCTCACCTT GAGTACAAATTACAACAGGGGGCCTTTT GAGTATAAATTACAGCAAGGTACATTCT	{5827} {5732} {5732}
4.661551599001681	25914	26100	186	25914	3	0.996969696969697	TGCTGGAAGTGCAAATCCAAAAACCCATTA TGCTGGAAGTGCAGATCCAAAAATCCATTA TGTTGGAAGTGCAAATCCAAGAACCCATTA	26070	1	0.996969696969697	GAAGACTACCAAATTGGTGGTTATTCTGAG	4	0.990909090909091	AGGTGATGGAACAAATCAGCCAAAACTA CTGTATACCATATAACAGTGTCACGGAT TCACTGACACAATTGTCCTCACGTCAGG TGCAGGTGACGGCATTTCAACACCAAAA	{26039} {25994} {26014} {26036}
4.907778667660241	30062	30218	156	30062	3	0.996969696969697	AGGGGAAATTCTCCTGCTCGAATGGCTAGC AGGGGAACTTCTCCTGCTCGAATTGCTAGT AGGGGAAGTTCTCCTGCTCGATTGGCTAGC	30188	2	0.996969696969697	ACTGTCACTAAGAAATCTGCTGCTGAGGCA ACTGTCACTAAGAAATCTGCTTCAGAGGCA	1	1.0	GGAGGTGGTGAAACTGCCCTCGCGCTAT	{30092}
4.9571942636812	27453	27625	172	27453	2	1.0	GACTTCCAGGTTACAATAGCAGAGATATTG GACTTTCAGGTTACAATAGCAGAGATGTTG	27595	3	0.996969696969697	CCTCAGTTAGATGATGAAGAACCTATGGAG TCAGAGTTAGATGATGAAGTACCTATGGAG TCGGAGTTAGATGATGAAGAACCTATGGAG	1	1.0	GAGACAATTATTTAAGCCTCTAACTAAG	{27558}
4.960043765448655	27073	27246	173	27073	3	0.996969696969697	CAGAAACAAACATTCTTCTCAATGTGCCTC CAGAAACAAATATCCTTCTCAATGTGCCTC CGGAAACAAACATTCTTCCCAATGTGCCTC	27216	2	0.996969696969697	AAGGACCTGCCAAAAGAGATCACTGTGGCT AAGGACCTGCCAAAAGAGATTACGGTGGCT	1	0.996969696969697	CATTCGTGGTCACTTGCGAATGGCCGGA	{27164}
4.965667889319841	26778	26953	175	26778	2	0.996969696969697	CTCCTGGAACAATGGAACCTAGTAATAGGT CTCTTGGAACAATGGAACCTAGTAATAGGA	26923	3	0.996969696969697	GCTTTGTGCTTGCTGCTGTTTACAGAATTA GTTTTGTGCTTGCTGCTGTCTACAGAATTA GTTTTGTGCTTGCTGCTGTTTACAGAATCA	1	0.9939393939393939	GCCTGGATTATGTTACTACAATTTGCCT	{26820}
4.971195040691433	26568	26745	177	26568	1	1.0	TTGTGTGCGTACTGCTGCAATATTGTTAAC	26715	4	0.996969696969697	GGAACTTTAACATTGCTTATCATGGCAGAC GGAACTTTAACATTGCTTATCATGGCTGAG GGAACTTTAACATTGCTTGTCATGGCAGAG GGAACTTTAACATTGCTTGTCATGGCTGAC	1	0.996969696969697	GTGAGTTTAGTAAAACCAACGGTTTACG	{26598}
5.015421916171136	24762	25012	250	24762	1	0.996969696969697	TGCTGCTACTAAAATGTCTGAGTGTGTTCT	24982	3	0.996969696969697	AATGGCACTTCGTGGTTTATCACACAGAGG AATGGCACTTCTTGGTTCATCACACAGAGG AATGGCACTTCTTGGTTTATTACACAGAGG	6	0.9848484848484849	ACATGTCACATATGTGCCATCTCAGGAG AGCTATTTGTCACGAAGGCAAAGCTTAT CCAGCAATTTGTCATGAAGGCAAGGCGT GTCACTTATGTGCCATCGCAGGAAAGAA TCACATATGTGCCATCGCAAGAGAAAAA TCACGTATGTGCCATCCCAGGAGAGGAA	{24879} {24927} {24925} {24883} {24884} {24884}
5.050843513028185	27051	27186	135	27051	3	0.996969696969697	CGCTCAATGTGGTCATTCAACCCAGAAACA CGCTCGATGTGGTCATTCAATCCAGAAACA CGTTCTATGTGGTCATTCAATCCAGAAACT	27156	2	0.996969696969697	GCTGTGATCATTCGTGGTCACTTGCGAATG GCTGTGATCATTCGTGGTCATTTGCGGATG	3	0.9878787878787879	CATTCTTCTCAATGTGCCTCTCCGGGGG CATTCTTCTCAATGTGCCTCTTCGAGGA CGGGGGACAATTGTGACCAGACCGCTCA	{27083} {27083} {27105}
5.059279969342407	7592	7729	137	7592	3	0.996969696969697	GATCCTTCTATGTCTATGCTAACGGAGGAC GATCTTTCTACGTCTATGCAAATGGAGGTC GATCTTTCTATGTCTATGCAAATGGAGGCC	7699	2	0.996969696969697	GAAGTAGCTCATGATTTGTCACTCCAGTTT GAAGTTGCTCGTGATTTGTCACTCCAGTTT	3	0.996969696969697	GTGGCTTCTGCAAGACGCACAATTGGAA GTGGCTTCTGCAAGACTCACAATTGGAA GTGGCTTCTGTAAGGCTCACAATTGGAA	{7622} {7622} {7622}
5.071143765448655	7556	7729	173	7556	3	0.996969696969697	GCGTTGAGTGTACAACTATTGTTAATGGCA GTGTTGAGTGCACAACCATAGTTAATGGCA GTGTTGAGTGTACAACTATTGTCAATGGCG	7699	2	0.996969696969697	GAAGTAGCTCATGATTTGTCACTCCAGTTT GAAGTTGCTCGTGATTTGTCACTCCAGTTT	2	0.996969696969697	GAGGCCGTGGCTTCTGCAAGACTCACAA GTGGCTTCTGTAAGGCTCACAATTGGAA	{7616} {7622}
5.087172931341441	781	1009	228	781	2	1.0	TATGAACAAAACTGGAACACTAAGCATGGC TATGAACAACAATGGAACACTAAGCATGGC	979	3	0.996969696969697	GAATCGAAGAGAGGCGTCTACTGCTGCCGT GAATCGAAGCGTGGTGTCTATTGCTGCCGT GAGTCGAAGAGAGGTGTCTACTGCTGCCGT	1	0.996969696969697	GCGGGCAAGTCAATGTGCACTCTTTCCG	{934}
5.120964373321448	510	702	192	510	3	0.996969696969697	GCCCTATGTGTTCATCAAACGTTCTGACGC GCCCTATGTGTTCATTAAACGATCTGAAGC GCCCTATGTGTTCATTAAACGTTCTGATGC	672	2	1.0	TGTTCTTCTCCGTAAGAATGGTAATAAGGG TGTTCTTCTTCGTAAGAACGGTAATAAGGG	2	0.996969696969697	CACAAGGTTGTGGAATTGGTTGCAGAAT CACTGGGAGTACTCGTGCCACATGTGGG	{559} {620}
5.124930266661923	5483	5732	249	5483	4	0.996969696969697	GAAACTATGACCCATCTTCTACAACATGCC GAAACTATGACCCATCTTCTACAGCATGCT GAAACTATGACTCATCTTTTACAGCACGCT GAAACTATGGCCCATCTTTTACAGCATGCT	5702	1	0.996969696969697	TCTTTTGTTATGATGTCTGCACCACCTGCT	1	0.990909090909091	TATCTTATGATAATCTTAAGACAGGTGT	{5616}
5.130534243325825	1119	1315	196	1119	3	0.996969696969697	GGAATGCCCAAAGTTTGTATTTCCTCTCAA GGAATGCCCAAAGTTTGTGTTTCCTCTTAA GGAATGCCCGAAGTTCGTATTTCCTCTCAA	1285	2	0.996969696969697	AATCATTGCGATGAAGTTTCATGGCAGACG AATCATTGTGATGAAGCTTCTTGGCAGACG	2	1.0	AAAAATACTGAAGGTTTCATGGGGCGTA GGCGCATTCGCTCTGTGTACCCTGTTGC	{1186} {1208}
5.166189493487165	1285	1421	136	1285	2	0.996969696969697	AATCATTGCGATGAAGTTTCATGGCAGACG AATCATTGTGATGAAGCTTCTTGGCAGACG	1391	3	0.996969696969697	ACCTACCTACTAATGCTGTAGTAAAGATGC ACCTACCTACTAATGCTGTAGTGAAAATGC ACCTACCTGCTAATGCTGTAGTAAAAATGC	4	0.9939393939393939	AATCACTGAAGGACCTACTACATGTGGG ACGCAGTCACTGAAGGACCTACTACATG ATTGTGGCACTGAAAATCCAGTGAGTGG GTTTGTGAAGGACCCACTACATGTGGAT	{1362} {1358} {1343} {1363}
5.176519205502994	1188	1359	171	1188	4	0.996969696969697	AAAGACTGAAGGTTTCATGGGGCGCATTCG AAAGACTGAGGGCTTCATGGGGCGTATTCG AAAGACTGAGGGTTTCATGGGGCGTATACG AAATACTGAAGGTTTCATGGGGCGTATACG	1329	1	0.996969696969697	AGCCACTTGTGAACATTGTGGCACTGAAAA	3	1.0	ATGAATGCAACGACATGCACTTGTCTGT CTTGTCTACCTTGATGAAATGTAATCAT TGTACCCTGTTGCTACTCCTCAAGAGTG	{1244} {1263} {1223}
5.198272931341441	984	1212	228	984	3	0.996969696969697	GAAGAGAGGTGTCTACTGCTGCCGTGAACA GAAGAGAGGTGTCTACTGCTGCCGTGACCA GAAGCGAGGTGTCTATTGCTGCCGTGAACA	1182	2	0.996969696969697	AAAGAAAAAGACTGAAGGTTTCATGGGGCG AAAGAAAAAGACTGAGGGTTTCATGGGGCG	2	1.0	AAGTTCGTATTTCCTCTCAACTCCAAAG AAGTTCGTATTTCCTCTTAACTCTAAAG	{1129} {1129}
5.206809836406474	9296	9478	182	9296	4	0.996969696969697	CTACCAGTGGTAGATGGGTTCTTAATAATG CTACTAGCGGTAGATGGGTTCTTAATAATG CTACTAGCGGTAGGTGGGTTCTTAACAATG CTACTAGTGGCCGATGGGTTCTTAACAATG	9448	1	0.996969696969697	GGTGGTATTATTGCCATATTGGTGACTTGT	3	1.0	ACCTGTCGGTGCTCTAGATGTGTCTGCT GTGGTGTTGATGCGATGAATCTCATAGC TGTGGAGTCGATGCAATGAATCTTATAG	{9408} {9356} {9355}
5.20942672308638	26919	27102	183	26919	2	0.996969696969697	GCTTGCTTTGTGCTTGCTGCTGTTTACAGA GCTTGTTTTGTGCTTGCTGCTGTCTACAGA	27072	3	0.996969696969697	CCAGAAACAAACATTCTTCTCAATGTGCCT CCAGAAACAAATATCCTTCTCAATGTGCCT CCGGAAACAAACATTCTTCCCAATGTGCCT	3	0.9878787878787879	ATCAATTGGGTGACTGGCGGTATTGCGA TCAATTGGGTGACTGGTGGGATTGCGAT TTAATTGGGTGACTGGCGGGATTGCGAT	{26949} {26950} {26950}
5.215001953228442	26093	26330	237	26093	4	0.996969696969697	TTCCGAGGATTGGCATTCAGGTGTAAAGGA TTCTGAGAATTGGCACTCAGGTGTTAAAGA TTCTGAGGATAGGCACTCAGGTGTTAAAGA TTCTGAGGATTGGCATTCAGGTGTTAAAGA	26300	1	1.0	AATGGATCCAATTTATGATGAGCCGACGAC	2	0.996969696969697	TACATTCTTCATCTATAGCAAGCTTGTT TCACCGAAGTTTACTACCAGCTTGAGTC	{26210} {26146}
5.236030266661922	937	1186	249	937	4	0.996969696969697	GGCAAATCGATGTGCACTCTTTCTGAACAA GGCAAGTCAATGTGCACTCTTTCCGAACAA GGTAAGTCGATGTGCACTCTTTCCGAACAA GGTAAGTCTATGTGCACTCTTTCTGAACAA	1156	1	1.0	GTCAAAGTCATTCAACCACGTGTTGAAAAG	2	0.990909090909091	CTCGATTTCATTGAATCGAAGCGTGGTG CTTGATTACATCGAGTCGAAGAGAGGTG	{967} {967}
5.317016028494806	7359	7462	103	7359	3	0.996969696969697	TGCCAGTCATTTCATTAGCAATTCTTGGCT TGCTAGTCATTTCATCAGCAACTCATGGCT TGCTAGTCATTTCATCAGCAATTCTTGGCT	7432	3	1.0	GCAATGGTTAGGATGTACATCTTCTTTGCT GCAATGGTTAGGATGTACATTTTCTTCGCT GCTATGGTCAGGATGTACATTTTCTTTGCT	1	0.9939393939393939	TTAGCATCGTACAGATGGCACCCGTTTC	{7403}
5.333265756109888	9237	9478	241	9237	4	1.0	TGATGCAGAGTACTGCCGTCATGGCACATG TGATGCGGAGTACTGTAGGCATGGTACTTG TGATGCTGAGTACTGTAGACATGGTACATG TGATGCTGAGTATTGCAGACATGGTACTTG	9448	1	0.996969696969697	GGTGGTATTATTGCCATATTGGTGACTTGT	3	1.0	ACCTGTCGGTGCTCTAGATGTGTCTGCT GTGGTGTTGATGCGATGAATCTCATAGC TGTGGAGTCGATGCAATGAATCTTATAG	{9408} {9356} {9355}
5.343164373321448	507	633	126	507	2	0.996969696969697	ACAGCCCTATGTGTTCATTAAACGTTCTGA AGAGCCCTATGTGTTCATTAAACGATCTGA	603	3	1.0	CGGTCGTAGCGGTACAACACTGGGAGTTCT CGGTCGTAGCGGTATAACACTGGGAGTACT CGGTCGTAGCGGTATAACTCTGGGAGTGCT	6	0.9939393939393939	ATCACGGCCACAAGGTCGTTGAGCTGGT CACAAGGTTGTGGAATTGGTTGCAGAAT CCACAAGGTCTGTGAGCTAGTTGCTGAA TAAGGTTGTTGAATTGGTGGCTGAAATG TCGTTGAGCTGGTTGCAGAAATGGACGG TCGTTGAGCTGGTTGCAGAATTGGACGG	{551} {559} {558} {561} {566} {566}
5.402822592664184	7432	7651	219	7432	3	1.0	GCAATGGTTAGGATGTACATCTTCTTTGCT GCAATGGTTAGGATGTACATTTTCTTCGCT GCTATGGTCAGGATGTACATTTTCTTTGCT	7621	2	0.996969696969697	CGTGGCTTCTGCAAGACTCACAATTGGAAT CGTGGCTTCTGTAAGGCTCACAATTGGAAT	4	0.996969696969697	ACGCAATCGTGCGACACGTGTTGAGTGT AGCGCAATCGTGCTATGCGCGTTGAGTG GCAACCGTGCTACACGTGTTGAGTGTAC GCGCAATCGTGCCACACGCGTTGAGTGT	{7539} {7538} {7541} {7539}
5.433559109049144	729	964	235	729	1	1.0	TCTAAAGTCTTATGACTTAGGTGACGAGCT	934	4	0.996969696969697	GCGGGCAAATCGATGTGCACTCTTTCTGAA GCGGGCAAGTCAATGTGCACTCTTTCCGAA GCGGGTAAGTCGATGTGCACTCTTTCCGAA GCGGGTAAGTCTATGTGCACTCTTTCTGAA	4	0.9939393939393939	AGATTATGAACAACAATGGAACACTAAG CTAAGCATGGTGGTGGTGTACTCCGTGA TCACTCGTGAGCTCAATGGAGGTGTAGT TTGATTGCATCAAGGATTTTCTCGCTCG	{777} {800} {830} {905}
5.473226686365171	9383	9478	95	9383	5	0.996969696969697	CAAACATCTTTACTCCCCTTGTGCAACCTG CAAACATTTTCACTCCCCTTGTGCAACCTG CTAACATCTTTACACCTCTTGTTCAACCTG CTAACATCTTTACTCCTCTTGTGCAACCTG CTAATATCTTCACACCTCTTGTTCAACCTG	9448	1	0.996969696969697	GGTGGTATTATTGCCATATTGGTGACTTGT	3	0.990909090909091	GCTCTAGATGTGTCTGCTTCAGTAGTAG TGGGTGCTTTAGATGTGTCTGCTTCAGT TTGGTGCTTTAGATGTGTCTGCTTCTGT	{9418} {9413} {9413}
5.5159324226839725	417	637	220	417	2	0.996969696969697	GGAAGAAGCCCTAGCGGAAGCACGTGAACA GGAAGAGGCCCTATCGGAGGCACGTGAACA	607	3	1.0	CGTAGCGGTACAACACTGGGAGTTCTCGTG CGTAGCGGTATAACACTGGGAGTACTCGTG CGTAGCGGTATAACTCTGGGAGTGCTCGTG	5	0.9939393939393939	ATCACGGCCACAAGGTCGTTGAGCTGGT ATGTGTTCATTAAACGATCTGAAGCCTT TCGTTGAGCTGGTTGCAGAATTGGACGG TGGTATAGTAGAGCTGGAAAAAGGCGTA TGTTCATTAAACGATCTGATGCCTTAAG	{551} {515} {566} {465} {518}
5.539216028494806	5586	5732	146	5586	5	0.996969696969697	GTGTAGAAGCCGTGATGTACATGGGTACTT GTGTAGAAGCTGTGATGTATATGGGTACTC GTGTAGAGGCCGTGATGTACATGGGTACTT GTGTAGAGGCTGTAATGTATATGGGCACAT GTGTAGAGGCTGTGATGTACATGGGGACTC	5702	1	0.996969696969697	TCTTTTGTTATGATGTCTGCACCACCTGCT	1	0.990909090909091	TATCTTATGATAATCTTAAGACAGGTGT	{5616}
5.550207968360733	860	1009	149	860	3	0.996969696969697	CTCGCTATGTCGACAACAACTTCTGTGGCC CTCGCTATGTCGACAACAATTTCTGTGGCC CTCGCTATGTTGATAACAACTTTTGTGGCC	979	3	0.996969696969697	GAATCGAAGAGAGGCGTCTACTGCTGCCGT GAATCGAAGCGTGGTGTCTATTGCTGCCGT GAGTCGAAGAGAGGTGTCTACTGCTGCCGT	1	0.996969696969697	GCGGGCAAGTCAATGTGCACTCTTTCCG	{934}
5.574478667660241	7626	7782	156	7626	2	1.0	CTTCTGCAAGACTCACAATTGGAATTGTCT CTTCTGTAAGGCTCACAATTGGAATTGTCT	7752	4	0.996969696969697	CCAGTCATCGTATATTGTTGATAGTGTTGC CCAGTCCTCGTATGTCGTTGATAGTGTTGC CCAGTCTGCATATGTCGTGGATAGCGTTAC CCAGTCTTCTTATGTTGTTGATAGTGTTGC	1	1.0	CTCGTGATTTGTCACTCCAGTTTAAAAG	{7706}
5.678983757168364	26715	26908	193	26715	4	0.996969696969697	GGAACTTTAACATTGCTTATCATGGCAGAC GGAACTTTAACATTGCTTATCATGGCTGAG GGAACTTTAACATTGCTTGTCATGGCAGAG GGAACTTTAACATTGCTTGTCATGGCTGAC	26878	2	0.996969696969697	TAAAGCTTGTTTTCCTCTGGCTCTTGTGGC TAAAGCTTGTTTTCCTCTGGCTTTTATGGC	1	0.9939393939393939	GCCTGGATTATGTTACTACAATTTGCCT	{26820}
5.69997380995394	9347	9478	131	9347	5	1.0	GAGTATTCTGTGGTGTTGATGCAATGAATC GAGTCTTTTGTGGTGTTGATGCCATGAATC GAGTTTTCTGTGGAGTCGATGCTATGAATC GAGTTTTCTGTGGTGTCGATGCTATGAACC GAGTTTTCTGTGGTGTTGATGCGATGAATC	9448	1	0.996969696969697	GGTGGTATTATTGCCATATTGGTGACTTGT	3	0.990909090909091	ACCTGTCGGTGCTCTAGATGTGTCTGCT TTACTCCTCTTGTGCAACCTGTGGGTGC TTTACTCCCCTTGTTCAGCCTGTGGGTG	{9408} {9392} {9391}
5.717343925003942	9012	9178	166	9012	2	0.996969696969697	GTATAGTGATTTTGCTACCTCTGCTTGCGT GTATAGTGATTTTTCCACTTCTGCTTGCGT	9148	4	0.996969696969697	CCAGACACTCGTTATGTGCTTATGGATGGT CCTGACACCCGTTATGTGCTCATGGATGGT CCTGACACTCGCTATGTGCTTATGGACGGT CCTGACACTCGTTATGTGCTTATGGATGGC	2	0.996969696969697	AGGATGCTATGGGTAAGCCTGTGCCATA CTAGAGGGTTCTATTTCTTATAGTGAGC	{9068} {9115}
5.732119205502993	26159	26330	171	26159	5	0.996969696969697	CTACCAGCTCGAATCGACTCAATTGTCGAC CTACCAGCTTGAGTCTACACAAATTACTAC CTACCAGTTAGAATCGACACAACTATCGAC TTACCAGCTTGAATCGACTCAATTGTCGAC TTACCAGTTGGAAACGACACAATTGTCGCC	26300	1	1.0	AATGGATCCAATTTATGATGAGCCGACGAC	2	0.996969696969697	CGAATGTGCAAATACACACAATCGACGG TACATTCTTCATCTATAGCAAGCTTGTT	{26248} {26210}
5.738232422683972	7626	7846	220	7626	2	1.0	CTTCTGCAAGACTCACAATTGGAATTGTCT CTTCTGTAAGGCTCACAATTGGAATTGTCT	7816	4	0.996969696969697	AAGGCTGGCCAAAAGACTTATGAGAGGCAC AAGGCTGGTCAAAAGACCTATGAGAGACAT AAGGCTGGTCAAAAGACTTATGAGAGACAC AAGGCTGGTCAGAAGACTTACGAGAGACAC	1	1.0	CTCGTGATTTGTCACTCCAGTTTAAAAG	{7706}
5.742214670640964	9453	9594	141	9453	1	0.996969696969697	TATTATTGCCATATTGGTGACTTGTGCTGC	9564	5	0.996969696969697	TTTCACTATACTCTGTCTGGCACCAGCTTA TTTCACTATACTCTGTCTGGCACCTGCTTA TTTCACTATACTCTGTCTGGTACCAGCTTA TTTCACTATACTCTGTTTGGCACCTGCCTA TTTTACTATACTCTGCCTGGCACCTGCTTA	3	0.990909090909091	ATGTTGTTGCTGCAAATGCATTACTGTT CCGCTAATGCATTGCTGTTTCTAATGTC GTTGTTGCTGCTAATGCACTTTTGGTTT	{9527} {9536} {9529}
5.744187395870146	26715	26938	223	26715	4	0.996969696969697	GGAACTTTAACATTGCTTATCATGGCAGAC GGAACTTTAACATTGCTTATCATGGCTGAG GGAACTTTAACATTGCTTGTCATGGCAGAG GGAACTTTAACATTGCTTGTCATGGCTGAC	26908	2	0.996969696969697	CAGTAACACTCGCTTGCTTTGTGCTTGCTG CAGTAACACTTGCTTGTTTTGTGCTTGCTG	1	0.9939393939393939	GCCTGGATTATGTTACTACAATTTGCCT	{26820}
5.751959093787734	7359	7586	227	7359	3	0.996969696969697	TGCCAGTCATTTCATTAGCAATTCTTGGCT TGCTAGTCATTTCATCAGCAACTCATGGCT TGCTAGTCATTTCATCAGCAATTCTTGGCT	7556	3	0.996969696969697	GCGTTGAGTGTACAACTATTGTTAATGGCA GTGTTGAGTGCACAACCATAGTTAATGGCA GTGTTGAGTGTACAACTATTGTCAATGGCG	1	0.9878787878787879	CATTAGTATTGTACAAATGGCACCCGTT	{7401}
5.762409836406473	8874	8995	121	8874	4	0.996969696969697	TACAAGAGAGATTGGTTTCATAGTGCCTGG TACTAGAGAAATTGGTTTCATAGTGCCTGG TACTAGAGAGATTGGCTTCATAGTGCCTGG TACTAGGGAGATTGGCTTCATCGTGCCTGG	8965	2	0.996969696969697	TTCAGTGCTGTTGGCAATATTTGCTACACA TTTAGTGCTGTTGGCAACATTTGCTACACA	4	0.9939393939393939	CGGGTACTGTGCTGAGAGCAATCAATGG CTGGTACTGTGTTAAGAACAATTAATGG CTGTTTTGAGAGCAATCAATGGTGACTT TGAGAGCACTTAATGGTGACTTTTTGCA	{8909} {8909} {8915} {8921}
5.784772960526724	9296	9541	245	9296	4	0.996969696969697	CTACCAGTGGTAGATGGGTTCTTAATAATG CTACTAGCGGTAGATGGGTTCTTAATAATG CTACTAGCGGTAGGTGGGTTCTTAACAATG CTACTAGTGGCCGATGGGTTCTTAACAATG	9511	2	1.0	TTTGGTGAATACAACCATGTTGTTGCTGCC TTTGGTGAGTACAACCATGTTGTTGCTGCT	1	0.996969696969697	ATTATTGCCATATTGGTGACTTGTGCTG	{9454}
5.803288527362399	2880	3038	158	2880	3	0.996969696969697	GCTTAATGAAAAGTGCTCTGTCTACACTGT GCTTAATGAGAAGTGCTCTGTTTACACTGT GCTTAATGAGAAGTGTTCTGTCTACACTGT	3008	3	0.996969696969697	TTGACCTTGACGAGTGGAGTGTAGCTACAT TTGATCTTGATGAATGGAGTGTGGCTACAT TTGATCTTGATGAGTGGAGTGTAGCTACAT	3	0.990909090909091	ACTGAGGTTACTGAATTCGCATGTGTTG CAACCAGTTTCTGATCTTCTTACCAAGA TTCGCATGTGTTGTAGCGGAAGCTGTTG	{2920} {2974} {2935}
5.808808310503012	26159	26360	201	26159	5	0.996969696969697	CTACCAGCTCGAATCGACTCAATTGTCGAC CTACCAGCTTGAGTCTACACAAATTACTAC CTACCAGTTAGAATCGACACAACTATCGAC TTACCAGCTTGAATCGACTCAATTGTCGAC TTACCAGTTGGAAACGACACAATTGTCGCC	26330	1	1.0	GACTACTAGCGTGCCTTTGTAAGCACAAGA	2	0.996969696969697	CGAATGTGCAAATACACACAATCGACGG TACATTCTTCATCTATAGCAAGCTTGTT	{26248} {26210}
5.830773533078032	8967	9178	211	8967	2	0.996969696969697	CAGTGCTGTTGGCAATATTTGCTACACACC TAGTGCTGTTGGCAACATTTGCTACACACC	9148	4	0.996969696969697	CCAGACACTCGTTATGTGCTTATGGATGGT CCTGACACCCGTTATGTGCTCATGGATGGT CCTGACACTCGCTATGTGCTTATGGACGGT CCTGACACTCGTTATGTGCTTATGGATGGC	2	0.9878787878787879	CTAGAGGGTTCTATTTCTTATAGTGAGC CTCATTGAGTATAGTGATTTTTCTACTT	{9115} {9004}
5.892388504066714	459	702	243	459	4	0.996969696969697	CACTTGTGGCTTAGTAGAGCTGGAAAAAGG CACTTGTGGCTTAGTGGAGCTGGAAAAAGG CACTTGTGGTCTAGTAGAGCTGGAAAAAGG CACTTGTGGTTTAGTAGAGCTGGAAAAGGG	672	2	1.0	TGTTCTTCTCCGTAAGAATGGTAATAAGGG TGTTCTTCTTCGTAAGAACGGTAATAAGGG	2	0.996969696969697	CACAAGGTTGTGGAATTGGTTGCAGAAT CACTGGGAGTACTCGTGCCACATGTGGG	{559} {620}
5.893870128054923	8850	9040	190	8850	4	1.0	CTGCCCTGTAGTAGCTGCTATCATTACAAG CTGCCCTGTAGTAGCTGCTATCATTACTAG CTGCCCTGTTGTAGCCGCTATCATTACTAG CTGCCCTGTTGTAGCTGCCATCATTACTAG	9010	2	0.996969696969697	GAGTATAGTGATTTTGCTACCTCTGCTTGC GAGTATAGTGATTTTTCCACTTCTGCTTGC	3	0.9939393939393939	AGTGCCTGGTTTACCTGGTACTGTTTTG CGGGTACTGTGCTGAGAGCAATCAATGG CGTGCCTGGATTACCTGGTACTGTGTTA	{8895} {8909} {8895}
5.90102964284277	9012	9260	248	9012	2	0.996969696969697	GTATAGTGATTTTGCTACCTCTGCTTGCGT GTATAGTGATTTTTCCACTTCTGCTTGCGT	9230	4	1.0	CAACTTTTGATGCAGAGTACTGCCGTCATG CAACTTTTGATGCGGAGTACTGTAGGCATG CAACTTTTGATGCTGAGTACTGTAGACATG CAACTTTTGATGCTGAGTATTGCAGACATG	2	0.996969696969697	AGGATGCTATGGGTAAGCCTGTGCCATA CTAGAGGGTTCTATTTCTTATAGTGAGC	{9068} {9115}
5.935440537842752	26940	27148	208	26940	5	0.996969696969697	GTCTACAGAATTAATTGGGTGACTGGCGGG GTTTACAGAATCAATTGGGTGACTGGCGGG GTTTACAGAATTAACTGGGTGACCGGTGGA GTTTACAGAATTAATTGGGTGACTGGCGGA GTTTACAGAATTAATTGGGTGACTGGTGGG	27118	1	0.996969696969697	TGACCAGACCGCTCATGGAAAGTGAACTTG	3	0.9939393939393939	CATTCTTCTCAATGTGCCTCTCCGGGGG CATTCTTCTCAATGTGCCTCTTCGGGGG CTTCTCAATGTGCCTCTCCGAGGAACAA	{27083} {27083} {27087}
5.939743513028184	1188	1398	210	1188	4	0.996969696969697	AAAGACTGAAGGTTTCATGGGGCGCATTCG AAAGACTGAGGGCTTCATGGGGCGTATTCG AAAGACTGAGGGTTTCATGGGGCGTATACG AAATACTGAAGGTTTCATGGGGCGTATACG	1368	2	0.996969696969697	TGAAGGACCCACTACATGTGGATACCTACC TGAAGGACCTACTACATGTGGGTACCTACC	3	1.0	ATGAATGCAACGACATGCACTTGTCTGT CTTGTCTACCTTGATGAAATGTAATCAT TGTACCCTGTTGCTACTCCTCAAGAGTG	{1244} {1263} {1223}
5.960043765448654	4279	4452	173	4279	4	0.996969696969697	CGGACAAGGATGTGCTGGTTATACACTCGA CGGTCAAGGTTGTGCTGGTTATACACTTGA TGGACAAGGATGTGCTGGCTATACACTCGA TGGACAAGGATGTGCTGGTTATACACTTGA	4422	2	1.0	ATGCTTGCTCATGCAGAGGAGACAAGAAAA ATGCTTGCTCATGCTGAAGAGACAAGAAAA	4	0.990909090909091	AAAATGCAAATCTGCACTGTATGTTCTA ACTATTCTTAAGAAATGCAAATCTGAAT CTGCGCTTAAAAGGTGCAAATCTGCATG GAAATGCAAATCTGCATTTTATGTACTA	{4331} {4320} {4321} {4331}
5.985474392180881	8807	9040	233	8807	4	0.996969696969697	CATGGTTTAGCCAGCGTGGTGGTTCATACA CATGGTTTAGCCAGCGTGGTGGTTCCTACA CTTGGTTTAGCCAGCGTGGCGGCTCTTACA CTTGGTTTAGCCAGCGTGGTGGTTCTTATA	9010	2	0.996969696969697	GAGTATAGTGATTTTGCTACCTCTGCTTGC GAGTATAGTGATTTTTCCACTTCTGCTTGC	3	1.0	ATTACTAGAGAGATTGGTTTCATAGTGC CTGTTTTGAGAGCAATCAATGGTGACTT GTTGTAGCTGCCATCATTACTAGGGAGA	{8872} {8915} {8857}
6.126621916171136	417	667	250	417	2	0.996969696969697	GGAAGAAGCCCTAGCGGAAGCACGTGAACA GGAAGAGGCCCTATCGGAGGCACGTGAACA	637	4	0.996969696969697	CCACACGTGGGCGAAACCCCAATCGCATAC CCACATGTGGGCGAAACCCCAATTGCATAC CCACATGTGGGCGAAACCCCAATTGCGTAC CCATATGTGGGCGAGACCCCAATTGCATAC	4	0.9939393939393939	ATGTGTTCATTAAACGATCTGAAGCCTT CACAAGGTTGTGGAATTGGTTGCAGAAT GAGCTGGAGAAAGGCGTTTTGCCCCAGC TAGCGGTATAACTCTGGGAGTACTCGTG	{515} {559} {475} {609}
6.139926686365172	9411	9541	130	9411	5	0.996969696969697	TGTAGGTGCTTTAGATGTTTCTGCTTCAGT TGTCGGTGCTCTAGATGTGTCTGCTTCAGT TGTGGGTGCCTTAGATGTGTCTGCTTCAGT TGTGGGTGCTTTAGATGTGTCTGCTTCAGT TGTTGGTGCTTTAGATGTATCTGCTTCTGT	9511	2	1.0	TTTGGTGAATACAACCATGTTGTTGCTGCC TTTGGTGAGTACAACCATGTTGTTGCTGCT	1	0.996969696969697	ATTATTGCCATATTGGTGACTTGTGCTG	{9454}
6.146254591467448	373	534	161	373	4	1.0	CTCCAGGTTAGAGACGTGCTAGTACGTGGC CTTCAGGTTAGAGACGTGCTAGTGCGTGGC CTTCAGGTTAGTGACGTGTTAGTGCGTGGT CTTCAGGTTGGCGACGTGCTAGTGCGTGGT	504	2	0.996969696969697	TGAACAGCCCTATGTGTTCATTAAACGTTC TGAAGAGCCCTATGTGTTCATTAAACGATC	6	0.9878787878787879	AGAGCTGGAAAAAGGTGTGTTGCCCCAG GAGCTGGAAAAGGGCGTATTGCCCCAGC GAGCTGGAGAAAGGCGTTTTGCCCCAGC GGAGCTGGAAAAAGGCGTACTGCCCCAG TGTGGCTTAGTGGAGCTGGAGAAGGGCG TTCGGGGATACTGTGGAAGAAGCCCTAG	{474} {475} {475} {474} {463} {403}
6.277389493487164	9012	9148	136	9012	2	0.996969696969697	GTATAGTGATTTTGCTACCTCTGCTTGCGT GTATAGTGATTTTTCCACTTCTGCTTGCGT	9118	5	0.996969696969697	GAAGGTTCCATTTCTTACAGTGAACTCCGC GAGGGTTCTATTTCTTACAGTGAGCTGCGT GAGGGTTCTATTTCTTATAGTGAACTCCGT GAGGGTTCTATTTCTTATAGTGAGCTTCGT GAGGGTTCTATTTCTTATAGTGAGTTGCGT	2	0.990909090909091	TTTCAAGGATGCTATGGGTAAGCCTGTG TTTTAAGGATGCTATGGGCAAACCTGTG	{9063} {9063}
6.28481812834518	1381	1551	170	1381	2	1.0	ACATGTGGGTACCTACCTACTAATGCTGTA ACGTGTGGATACCTACCTGCTAATGCTGTA	1521	5	0.996969696969697	TAGGACTAAATGTTTCGGTGGGTGTGTGTT TAGGACTAAATGTTTTGGAGGCTGTGTGTT TAGGACTAAATGTTTTGGGGGTTGTGTGTT TAGGACTAAGTGTTTTGGCGGCTGTGTATT TAGGACTAGATGTTTTGGAGGCTGTGTGTT	1	1.0	ACATTGAAACTCGACTCCGCAAGGGAGG	{1493}
6.330885737400775	822	1009	187	822	4	0.996969696969697	CCGCGAACTCATTCGTGAGCTCAACGGAGG CCGTGAACTCACTCGTGAGCTCAATGGAGG CCGTGAACTCATCCGTGAGCTCAATGGAGG CCGTGAACTCATTCGTGAGCTTAATGGAGG	979	3	0.996969696969697	GAATCGAAGAGAGGCGTCTACTGCTGCCGT GAATCGAAGCGTGGTGTCTATTGCTGCCGT GAGTCGAAGAGAGGTGTCTACTGCTGCCGT	1	0.996969696969697	GCGGGCAAGTCAATGTGCACTCTTTCCG	{934}
6.3334	3615	3739	124	3615	3	1.0	TGTTGGACCTAACCTAAATGCAGGTGAGGA TGTTGGACCTAACTTAAATGCCGGTGAGGA TGTTGGCCCAAACCTAAATGCTGGTGAGGA	3709	4	0.996969696969697	CTATCAGCTGGCATATTTGGTGCTAAACCA TTGTCAGCAGGCATATTTGGTGCTAAACCA TTGTCAGCTGGCATATTTGGTGCCAAACCA TTGTCAGCTGGTATATTTGGTGCTAAACCA	3	0.9939393939393939	AACTTTAATTCACAGGACGTATTACTTG AATTTCAATTCACAGGATGTATTACTTG GCAGCATATGAAAATTTCAATTCACAGG	{3673} {3673} {3661}
6.338635466635869	20790	20942	152	20790	2	0.996969696969697	AGAATGCTCCCTGAAAAATGTGACCTTCAG AGAATGCTTCTTGAAAAGTGTGACCTTCAG	20912	5	0.996969696969697	TAGCTGTACCCTACAACATGAGAGTTATTC TAGCTGTGCCATACAATATGAGAGTTATCC TAGCTGTGCCTTACAACATGAGAGTCATAC TAGCTGTGCCTTATAACATGAGAGTGATAC TGGCTGTACCTTACAACATGAGAGTTATAC	2	0.9878787878787879	CTGTCATACCAAAGGGAATAATGATGAA GTTATACCAAAAGGAATAATGAGGAATG	{20837} {20839}
6.340826590941622	7359	7550	191	7359	3	0.996969696969697	TGCCAGTCATTTCATTAGCAATTCTTGGCT TGCTAGTCATTTCATCAGCAACTCATGGCT TGCTAGTCATTTCATCAGCAATTCTTGGCT	7520	4	1.0	CGTGCATGATGTGCTACAAGCGCAATCGTG CTTGCATGATGTGCTACAAACGCAATCGTG CTTGCATGATGTGCTATAAGCGCAATCGTG CTTGCATGATGTGCTATAAGTGCAATCATG	1	0.9939393939393939	TTAGCATCGTACAGATGGCACCCGTTTC	{7403}
6.3480850181197175	9347	9541	194	9347	5	1.0	GAGTATTCTGTGGTGTTGATGCAATGAATC GAGTCTTTTGTGGTGTTGATGCCATGAATC GAGTTTTCTGTGGAGTCGATGCTATGAATC GAGTTTTCTGTGGTGTCGATGCTATGAACC GAGTTTTCTGTGGTGTTGATGCGATGAATC	9511	2	1.0	TTTGGTGAATACAACCATGTTGTTGCTGCC TTTGGTGAGTACAACCATGTTGTTGCTGCT	1	0.996969696969697	ATTATTGCCATATTGGTGACTTGTGCTG	{9454}
6.416733761645287	7556	7782	226	7556	3	0.996969696969697	GCGTTGAGTGTACAACTATTGTTAATGGCA GTGTTGAGTGCACAACCATAGTTAATGGCA GTGTTGAGTGTACAACTATTGTCAATGGCG	7752	4	0.996969696969697	CCAGTCATCGTATATTGTTGATAGTGTTGC CCAGTCCTCGTATGTCGTTGATAGTGTTGC CCAGTCTGCATATGTCGTGGATAGCGTTAC CCAGTCTTCTTATGTTGTTGATAGTGTTGC	1	1.0	CTCGTGATTTGTCACTCCAGTTTAAAAG	{7706}
6.426471411322415	8967	9148	181	8967	2	0.996969696969697	CAGTGCTGTTGGCAATATTTGCTACACACC TAGTGCTGTTGGCAACATTTGCTACACACC	9118	5	0.996969696969697	GAAGGTTCCATTTCTTACAGTGAACTCCGC GAGGGTTCTATTTCTTACAGTGAGCTGCGT GAGGGTTCTATTTCTTATAGTGAACTCCGT GAGGGTTCTATTTCTTATAGTGAGCTTCGT GAGGGTTCTATTTCTTATAGTGAGTTGCGT	2	0.9939393939393939	CTCATTGAGTATAGTGATTTTTCTACTT TTTTAAGGATGCTATGGGCAAACCTGTG	{9004} {9063}
6.463934243325825	3444	3640	196	3444	4	0.996969696969697	TGCTAACACCCACTTGAAACATGGTGGTGG TGCTAACATACACCTGAAACATGGTGGTGG TGCTAACATCCACCTAAAACATGGTGGTGG TGCTAACGTCCATCTGAAACATGGTGGTGG	3610	3	0.996969696969697	CATGTTGTTGGACCTAACCTAAATGCAGGT CATGTTGTTGGACCTAACTTAAATGCCGGT CATGTTGTTGGCCCAAACCTAAATGCTGGT	2	1.0	ACCAATGGTGCCATGCAACAGGAGAGTG GGTCATGTTTGCTTTCTGGACACAACCT	{3499} {3566}
6.4764648453679445	8345	8505	160	8345	2	1.0	CATGACGCCCAGAGATCTTGGCGCATGTAT CATGACGCCTAGAGATCTTGGTGCATGTAT	8475	5	0.996969696969697	CGCAAGCAAATTCGCAGTGCTGCCAAAAAG CGCAAGCAAATTCGTAGCGCTGCCAAAAAG CGCAAGCAAATTCGTAGTGCTGCTAAAAAG CGTAAACAAATTCGTAGTGCGGCTAAGAAG CGTAAACAAATTCGTAGTGCTGCCAAGAAG	3	0.9939393939393939	AATGTTTCACTCATCTGGAATGTAAAAG AGACTATATGTCATTGTCTGAACAGTTG TTTCGCTGGTTTGGAACGTCAAGGACTA	{8421} {8447} {8425}
6.484475799801318	937	1142	205	937	4	0.996969696969697	GGCAAATCGATGTGCACTCTTTCTGAACAA GGCAAGTCAATGTGCACTCTTTCCGAACAA GGTAAGTCGATGTGCACTCTTTCCGAACAA GGTAAGTCTATGTGCACTCTTTCTGAACAA	1112	3	0.996969696969697	TCAAAGGGGAATGCCCAAAGTTTGTATTTC TCAAAGGGGAATGCCCAAAGTTTGTGTTTC TTAAAGGGGAATGCCCGAAGTTCGTATTTC	2	0.990909090909091	CTCGATTTCATTGAATCGAAGCGTGGTG CTTGATTACATCGAGTCGAAGAGAGGTG	{967} {967}
6.503779969342407	9012	9226	214	9012	2	0.996969696969697	GTATAGTGATTTTGCTACCTCTGCTTGCGT GTATAGTGATTTTTCCACTTCTGCTTGCGT	9196	5	1.0	AACACCTACCTAGAAGGTTCTGTTAGAGTG AACACTTACCTGGAGGGTTCTGTTAGAGTA AACACTTACCTTGAGGGGTCTGTTAGAGTA AACACTTACTTGGAAGGTTCTGTTAGAGTG AACGCATACTTAGAAGGTTCTGTTAGAGTG	2	0.996969696969697	AGGATGCTATGGGTAAGCCTGTGCCATA CTAGAGGGTTCTATTTCTTATAGTGAGC	{9068} {9115}
6.542922044777588	4424	4658	234	4424	2	1.0	GCTTGCTCATGCAGAGGAGACAAGAAAATT GCTTGCTCATGCTGAAGAGACAAGAAAATT	4628	5	0.996969696969697	CACAATGCCAATTGGTTATGTGACACATGG CACAATGCCGATAGGTTATGTGACACATGG CACTATGCCTATTGGTTATGTGACACATGG TACTATGCCAATTGGTTATGTGACACATGG TACTATGCCCATAGGTTATGTGACACATGG	2	0.996969696969697	TTCTTTTTCTATACTAGCAAAGAGCCTG TTGTTGACTATGGAGTCCGATTCTTCTT	{4554} {4534}
6.544759109049143	20790	21025	235	20790	2	0.996969696969697	AGAATGCTCCCTGAAAAATGTGACCTTCAG AGAATGCTTCTTGAAAAGTGTGACCTTCAG	20995	5	0.996969696969697	CAATGGTTGCCAACTGGCACACTACTTGTC CAGTGGTTACCAACCGGCACACTACTTGTT CAGTGGTTGCCAACTGGCACACTACTTGTT CAGTGGTTGCCAATTGGCACACTACTTGTC CAGTGGTTGCCGATTGGCACACTACTCGTT	2	0.9878787878787879	CTGTCATACCAAAGGGAATAATGATGAA GTTATACCAAAAGGAATAATGAGGAATG	{20837} {20839}
6.558094696155048	24940	25129	189	24940	4	0.996969696969697	GAAGGCAAAGCATACTTCCCTCGTGAAGGT GAAGGCAAAGCCTACTTCCCGCGTGAAGGT GAAGGCAAAGCTTATTTCCCTCGTGAAGGT GAAGGCAAGGCATACTTCCCTCGTGAAGGT	25099	3	0.996969696969697	GTCTATGATCCTCTGCAACCTGAGCTAAAC GTTTATGATCCTCTGCAACCTGAGCTTGAC GTTTATGATCCTCTGCAGCCTGAACTTGAC	3	0.990909090909091	GTGTTTGTATCTAATGGCAGTTCTTGGT GTTTTTGTATCTAATGGCACTTCTTGGT TTGTGTTTAATGGCACTTCTTGGTTTAT	{24970} {24970} {24974}
6.562572960526724	8730	8975	245	8730	5	0.996969696969697	AGCCATCCAGGATGGCGTCACTCGTGACAT AGCCATTCAGGACGGTGTCACTCGTGATAT AGCCATTCAGGATGGTGTCACTCGTGACAT AGCTATCCAAGATGGTGTCACTCGTGACAT AGCTATCCAGGACGGTGTCACTCGTGACAT	8945	2	0.996969696969697	TGCATTTTCTACCTCGCGTTTTTAGTGCCG TGCATTTTCTACCTCGTGTTTTTAGTGCTG	2	0.9878787878787879	ATTACTAGAGAGATTGGTTTCATAGTGC CTGTTTTGAGAGCAATCAATGGTGACTT	{8872} {8915}
6.562572960526724	25604	25849	245	25604	2	0.996969696969697	AAGTACTGTTCATACTACTGCAACGATACC AAGTACTGTTCATGCTACAGCAACGATACC	25819	5	0.996969696969697	CTGCAGGTATGGAGGCGCAATTTTTGTACC CTGCCGGCATGGAAGCACAATTCTTGTACA CTGCTGGCATGGAGGCACAATTTTTGTACA CTGCTGGCATTGAGGTACAATTCTTGTACA CTGCTTGCATGGAAGCACAATTCTTGTACA	2	0.9939393939393939	AGCTAGCCCTTTATAAGGGCTTCCAGTT TCAAAGCGCTTCCAAAGTGATTGCGCTT	{25735} {25694}
6.57780063353398	5701	5858	157	5701	2	0.996969696969697	CTCTTTTGTTATGATGTCTGCACTACCTGC TTCTTTTGTTATGATGTCTGCACCACCTGC	5828	5	0.996969696969697	CTCTATCGCGTAGATGGAGCACATCTTACT CTCTATCGTATAGATGGAGCTCACCTTACA CTCTATCGTATTGACGGAGCTCACCTTACA CTTTATCGTATAGATGGGGCGTACCTCACT CTTTATCGTATTGATGGAGCGCATCTTACA	4	0.9878787878787879	TGAGTACAAATTACAACAGGGGGCCTTT TGAGTACAAATTACAGCAGAGCACATTT TGAGTATAAATTACAGCAAGGTACATTC TGTGGTCATTATACACATGTAACTGTTA	{5731} {5731} {5731} {5792}
6.614879969342407	4423	4560	137	4423	2	1.0	TGCTTGCTCATGCAGAGGAGACAAGAAAAT TGCTTGCTCATGCTGAAGAGACAAGAAAAT	4530	5	1.0	GGAATCGTGGATTACGGTGTCCGGTTCTTC GGAATCGTTGACTATGGTGTTCGGTTCTTT GGAATTGTTGACTATGGTGTCCGATTCTTC GGCATCGTTGACTATGGTGTCCGATTCTTC GGCATTGTTGACTATGGAGTCCGATTCTTC	5	0.990909090909091	AGCCATAATGGCTACAATCCAACGTAAG ATGCTTATTTGTATGGATGTTAAAGCCT TAATGCCTATATGCATGGATGTTAGAGC TAATGCCTATTTGCCTGGATGTTAGAGC TGATGCCTGTTTGCATGGATGTCCGGGC	{4478} {4455} {4453} {4453} {4453}
6.664889758004454	8364	8604	240	8364	4	0.996969696969697	GGCGCATGTATCGATTGTAATGCAAGGCAT GGCGCATGTATTGACTGTAATGCAAGGCAT GGTGCATGCATTGATTGTAATGCGAGGCAT GGTGCATGTATTGATTGTAATGCAAGGCAT	8574	3	0.996969696969697	TCACTCAAAGGTGGTAAGGTTGTTAGTACG TCACTCAAGGGTGGTAAGATTGTTAGTACT TCACTTAAGGGTGGTAAAGTCATTAGCACT	3	0.9939393939393939	AATGTTTCACTCATCTGGAATGTAAAAG AGACTATATGTCATTGTCTGAACAGTTG GACTTACCTGTGCTACTACTAGACAGGT	{8421} {8447} {8521}
6.675401087828205	26940	27186	246	26940	5	0.996969696969697	GTCTACAGAATTAATTGGGTGACTGGCGGG GTTTACAGAATCAATTGGGTGACTGGCGGG GTTTACAGAATTAACTGGGTGACCGGTGGA GTTTACAGAATTAATTGGGTGACTGGCGGA GTTTACAGAATTAATTGGGTGACTGGTGGG	27156	2	0.996969696969697	GCTGTGATCATTCGTGGTCACTTGCGAATG GCTGTGATCATTCGTGGTCATTTGCGGATG	3	0.9878787878787879	CATTCTTCTCAATGTGCCTCTCCGGGGG CATTCTTCTCAATGTGCCTCTTCGAGGA CGGGGGACAATTGTGACCAGACCGCTCA	{27083} {27083} {27105}
6.721889493487164	7267	7365	98	7267	5	0.996969696969697	GCAGCTGAATGGGTTTTGGCATATATGTTG GCAGCTGAATGGTTATTGGCATATATGTTG GCAGCTGAATGGTTTTTGGCATACATGTTG GCCGCTGAGTGGGTTTTGGCATATATGTTG GCTGCTGAGTGGTTTTTGGCATATATGTTG	7335	3	0.996969696969697	AATGCAAGCGTTCTTTGGCTACTTTGCCAG AATGCAGGTGTTCTTTGGCTATTTTGCTAG AATGCAGGTGTTTTTCGGCTACTTTGCTAG	2	0.996969696969697	ACAAAATTCTTTTATTTATTAGGTCTTT ACAAAGTTCTTCTACTTACTTGGTCTCT	{7300} {7300}
6.802014134296109	27496	27625	129	27496	5	0.996969696969697	AAACTTTCAGGGTTGCCATTTGGAACCTTG GAACTTTCAGGATTGCCATTTGGAATCTTG GGACTTTCAAGATTGCCATTTGGAATCTTG GGACTTTCAGGATTGCCATATGGAATCTTG GGACTTTCAGGATTGCTATTTGGAATCTTG	27595	3	0.996969696969697	CCTCAGTTAGATGATGAAGAACCTATGGAG TCAGAGTTAGATGATGAAGTACCTATGGAG TCGGAGTTAGATGATGAAGAACCTATGGAG	1	1.0	GAGACAATTATTTAAGCCTCTAACTAAG	{27558}
6.831453964378334	459	626	167	459	4	0.996969696969697	CACTTGTGGCTTAGTAGAGCTGGAAAAAGG CACTTGTGGCTTAGTGGAGCTGGAAAAAGG CACTTGTGGTCTAGTAGAGCTGGAAAAAGG CACTTGTGGTTTAGTAGAGCTGGAAAAGGG	596	3	0.996969696969697	TTCAGTACGGTCGTAGCGGTATAACACTGG TTCAGTACGGTCGTAGCGGTATAACTCTGG TTCAGTTCGGTCGTAGCGGTACAACACTGG	6	0.996969696969697	ACCAATCACTGCCACAAGGTCGTTGAGC ATCACGGCCACAAGGTCGTTGAGCTGGT ATGTGTTCATTAAACGATCTGAAGCCTT GTTCATTAAACGATCTGACGCCCAGGGC TCGTTGAGCTGGTTGCAGAATTGGACGG TGTTCATTAAACGATCTGATGCCTTAAG	{547} {551} {515} {519} {566} {518}
6.840418128345179	9063	9178	115	9063	4	0.996969696969697	CTTTAAGGATGCTATGGGTAAGCCTGTGCC TTTCAAAGATGCTATGGGTAAGCCTGTGCC TTTTAAGGATGCTATGGGCAAACCTGTGCC TTTTAAGGATGCTATGGGTAAGCCTGTGCC	9148	4	0.996969696969697	CCAGACACTCGTTATGTGCTTATGGATGGT CCTGACACCCGTTATGTGCTCATGGATGGT CCTGACACTCGCTATGTGCTTATGGACGGT CCTGACACTCGTTATGTGCTTATGGATGGC	2	0.9939393939393939	ACTTGAGGGTTCTATTTCTTATAGTGAA CTAGAGGGTTCTATTTCTTATAGTGAGC	{9114} {9115}
6.845400082244953	5834	5973	139	5834	5	0.996969696969697	CGCGTAGATGGAGCACATCTTACTAAGATG CGTATAGATGGAGCTCACCTTACAAAAATG CGTATAGATGGGGCGTACCTCACTAAAATG CGTATTGACGGAGCTCACCTTACAAAGATG CGTATTGATGGAGCGCATCTTACAAAGATG	5943	3	0.996969696969697	AACTCGATGGAGTCACTTACACAGAGATCG AACTCGATGGAGTTACTTACACAGAGATTG AGCTCGATGGAGTTATTTACACAGAGATTC	1	0.996969696969697	GTGACTGATGTTTTCTACAAGGAAACAT	{5882}
6.9899224201679635	25822	25944	122	25822	5	0.996969696969697	CAGGTATGGAGGCGCAATTTTTGTACCTCT CCGGCATGGAAGCACAATTCTTGTACATCT CTGGCATGGAGGCACAATTTTTGTACATCT CTGGCATTGAGGTACAATTCTTGTACATCT CTTGCATGGAAGCACAATTCTTGTACATCT	25914	3	0.996969696969697	TGCTGGAAGTGCAAATCCAAAAACCCATTA TGCTGGAAGTGCAGATCCAAAAATCCATTA TGTTGGAAGTGCAAATCCAAGAACCCATTA	3	0.9939393939393939	ATGTAGAATTATTATGAGATGTTGGCTT CTGATTTACATTCTGCAAATCGTAAGCT CTGTAGACTTATCATGAGATGCTGGCTT	{25886} {25857} {25886}
7.0171684256646945	7267	7462	195	7267	5	0.996969696969697	GCAGCTGAATGGGTTTTGGCATATATGTTG GCAGCTGAATGGTTATTGGCATATATGTTG GCAGCTGAATGGTTTTTGGCATACATGTTG GCCGCTGAGTGGGTTTTGGCATATATGTTG GCTGCTGAGTGGTTTTTGGCATATATGTTG	7432	3	1.0	GCAATGGTTAGGATGTACATCTTCTTTGCT GCAATGGTTAGGATGTACATTTTCTTCGCT GCTATGGTCAGGATGTACATTTTCTTTGCT	1	0.9939393939393939	TTAGCATCGTACAGATGGCACCCGTTTC	{7403}
7.028843040981688	5462	5621	159	5462	3	1.0	GGCGAGCTTGGTGATGTCAGAGAAACTATG GGTGAGTTAGGTGATGTTAGAGAAACTATG GGTGAGTTGGGTGATGTTAGGGAAACTATG	5591	5	0.996969696969697	GAAGCCGTGATGTATATGGGTACTTTGTCT GAAGCTGTGATGTATATGGGTACTCTATCT GAGGCCGTGATGTACATGGGTACTCTATCT GAGGCTGTAATGTATATGGGCACATTGTCC GAGGCTGTGATGTACATGGGGACTCTGTCT	2	0.990909090909091	CATCTTCTACAGCATGCTAATTTGGAAT GGACAGAAAACTACCACCTTAACGGGTG	{5495} {5561}
7.067600082244953	4748	4887	139	4748	5	0.996969696969697	CAATGGATACCTCACATCATCTTCAAAGAC TAATGGATACCTCACTTCGTCATCAAAGAC TAATGGATACCTTACATCGTCTTCGAAGAC TAATGGGTACCTCACGTCATCTTCAAAGAC TAATGGTTACCTCACTTCGTCTTCCAAGAC	4857	3	0.996969696969697	TTAGGTGTTGAATTTCTCAAGCGTGGAGAT TTAGGTGTTGAATTTCTTAAGCGTGGGGAT TTAGGTGTTGAATTTCTTAAGCGTGGTGAC	3	0.9878787878787879	CATAGAGACCATCTCCCTTGCGGGTACG CCTGAGGAGTATTTTGTGGAGACTACTT TAGAAACAGTTTCTTTGGCTGGCTCTTA	{4793} {4779} {4795}
7.068394263681199	26073	26189	116	26073	3	0.996969696969697	GACTACCAAATAGGTGGTTATTCTGAAGAC GACTACCAAATTGGTGGTTATTCCGAGTAT GACTACCAAATTGGTGGTTATTCTGAGGAT	26159	5	0.996969696969697	CTACCAGCTCGAATCGACTCAATTGTCGAC CTACCAGCTTGAGTCTACACAAATTACTAC CTACCAGTTAGAATCGACACAACTATCGAC TTACCAGCTTGAATCGACTCAATTGTCGAC TTACCAGTTGGAAACGACACAATTGTCGCC	4	0.996969696969697	ACTCAGGTGTGAAAGACTATGTAGTAAT TATGTCGTTGTACATGGCTATTTCACTG TCGTTGTACATGGCTACTTCACCGAAGT TCGTTGTACATGGCTATTTCACCGAAGT	{26107} {26124} {26128} {26128}
7.075614670640964	1331	1553	222	1331	3	0.996969696969697	CCACTTGTGAACAATGTGGCACTGAAAACG CCACTTGTGAACATTGTGGCACTGAAAATT CCACTTGTGAATATTGTGGCACTGAAAATC	1523	5	0.996969696969697	GGACTAAATGTTTTGGAGGCTGTGTGTTTT GGACTAAATGTTTTGGGGGCTGTGTGTTTG GGACTAAGTGTTTTGGCGGCTGTGTATTTT GGACTAGATGTTTTGGAGGCTGTGTGTTTG GGATTAAATGTTTCGGTGGGTGTGTGTTTG	1	1.0	CTACATGTGGGTACCTACCTACTAATGC	{1379}
7.082395040691432	3562	3739	177	3562	4	0.996969696969697	GGAGGGTCTTGTTTGCTTTCTGGACATAAT GGAGGTTCATGTTTGCTTTCTGGACACAAT GGAGGTTCATGTTTGCTTTCTGGACATAAC GGTGGTTCATGTTTGCTTTCTGGACATAAT	3709	4	0.996969696969697	CTATCAGCTGGCATATTTGGTGCTAAACCA TTGTCAGCAGGCATATTTGGTGCTAAACCA TTGTCAGCTGGCATATTTGGTGCCAAACCA TTGTCAGCTGGTATATTTGGTGCTAAACCA	2	0.990909090909091	GACCTAACCTAAATGCAGGTGAGGACAT TGGCTAAGAAGTGTATGCATGTTGTTGG	{3620} {3593}
7.085123285568201	4188	4307	119	4188	4	0.996969696969697	TAATACCCTCCAAAAAGGCTGGTGGCACTA TAATACCTGCCAAGAAGGCTGGCGGTACTA TAATACCTGCTAAGAAGGCTGGTGGTACTA TAATACCTGCTAAGAAGTCGGGTGGGACTA	4277	4	0.996969696969697	CCCGGACAAGGATGTGCTGGTTATACACTC CCCGGTCAAGGTTGTGCTGGTTATACACTT CCTGGACAAGGATGTGCTGGCTATACACTC CCTGGACAAGGATGTGCTGGTTATACACTT	4	0.9878787878787879	AAGGCATTAAAGAAAGTGCCAGTGTGTG AAGGCATTAAAGAAGGTGCCAGTTAGTG AGCTTTGAAGAAAGTGCCAGTTGATGAG GCAAGAGCACTAAAGGAAGTCCCAGTTG	{4232} {4232} {4234} {4229}
7.125885018119717	2911	3038	127	2911	5	0.996969696969697	GAATCCGGTACAGAGGTCAATGAATTCGCA GAATCCGGTACAGAGGTTACTGAATTCGCA GAATCCGGTACCGAAGTTACTGAGTTTGCA GAGTCAGGTACAGAAGTGTCTGAATTTGCA GAGTCTGGTACTGAGGTTACTGAATTCGCA	3008	3	0.996969696969697	TTGACCTTGACGAGTGGAGTGTAGCTACAT TTGATCTTGATGAATGGAGTGTGGCTACAT TTGATCTTGATGAGTGGAGTGTAGCTACAT	4	0.9939393939393939	AGCCGTTGTAAAAGCTTTGCAACCAGTT AGCGGAGTCTGTTGTGAAAACATTACAA CAACCAGTTTCTGATCTTCTTACCAAGA TGTGTTGTAGCGGAGGCTGTTGTGAAGA	{2955} {2949} {2974} {2941}
7.167836002980723	1872	2040	168	1872	4	0.996969696969697	AGGAGCTTGGAACATTGGACAACAGCGGTC AGGAGCTTGGAACATTGGACAGCAAAAATC AGGTGCTTGGAACATTGGACAACAAAAATC AGGTGCTTGGAACATTGGACAACAGAGATC	2010	4	0.996969696969697	AGCAGCTGTCACCACTCTTGATGGTATTTC AGCAGCTGTCACCATACTTGATGGTATTTC AGCAGCTGTCACCATCCTTGGTGACATTTC AGCAGCTGTTACCATCCTTGATGGTATTTC	3	0.9848484848484849	ATTTTGACACCGCTGTGTGGTTTTCCAT CCACTGTGTGGTTTTCCCTCACAGGCTG TGTGGATTTCCATCACAGGCTGCTGGTG	{1903} {1912} {1918}
7.17371812834518	4717	4887	170	4717	5	0.996969696969697	CAGTATCATCACCAGATGCTGTTACTACAT CAGTATCATCACCTGATGCCGTCACTACAT CAGTGTCTTCACCAGACGCAGTTACTACAT CAGTTTCTTCACCAGATGCTGTCACTGCAT CAGTTTCTTCACCCGATGCTGTTACTACAT	4857	3	0.996969696969697	TTAGGTGTTGAATTTCTCAAGCGTGGAGAT TTAGGTGTTGAATTTCTTAAGCGTGGGGAT TTAGGTGTTGAATTTCTTAAGCGTGGTGAC	3	0.9878787878787879	CATAGAGACCATCTCCCTTGCGGGTACG CTTCGTCTTCCAAGACACCTGAGGAGTA TAGAAACAGTTTCTTTGGCTGGCTCTTA	{4793} {4762} {4795}
7.180722592664184	8874	9093	219	8874	4	0.996969696969697	TACAAGAGAGATTGGTTTCATAGTGCCTGG TACTAGAGAAATTGGTTTCATAGTGCCTGG TACTAGAGAGATTGGCTTCATAGTGCCTGG TACTAGGGAGATTGGCTTCATCGTGCCTGG	9063	4	0.996969696969697	CTTTAAGGATGCTATGGGTAAGCCTGTGCC TTTCAAAGATGCTATGGGTAAGCCTGTGCC TTTTAAGGATGCTATGGGCAAACCTGTGCC TTTTAAGGATGCTATGGGTAAGCCTGTGCC	2	0.9878787878787879	CCATCTAAACTCATTGAGTATAGTGATT CGGGTACTGTGCTGAGAGCAATCAATGG	{8995} {8909}
7.193495040691433	2731	2908	177	2731	5	0.996969696969697	CCAGGATTGTTAGCAACAAACAATGTCTTC CCAGGCTTATTAGCTACAAACAATGTCTTC CCTGGCTTGTTAGCAACAAACAATGTCTTT CCTGGTTTACTGGCTACAAACAATGTCTTT CCTGGTTTATTAGCCACAAACAATGTCTTC	2878	3	0.996969696969697	GTGCTTAATGAAAAGTGCTCTGTCTACACT GTGCTTAATGAGAAGTGCTCTGTTTACACT GTGCTTAATGAGAAGTGTTCTGTCTACACT	3	0.996969696969697	AAGGTGTGACTTTTGGAGAGGACACTGT AGAATCACATTTGAGCTTGATGAACGTG GTCTAAAAGGAGGTGCACCAGTTAAAGG	{2786} {2842} {2762}
7.19837293134144	3444	3588	144	3444	4	0.996969696969697	TGCTAACACCCACTTGAAACATGGTGGTGG TGCTAACATACACCTGAAACATGGTGGTGG TGCTAACATCCACCTAAAACATGGTGGTGG TGCTAACGTCCATCTGAAACATGGTGGTGG	3558	4	1.0	AGTAGGAGGGTCTTGTTTGCTTTCTGGACA AGTAGGTGGTTCATGTTTGCTTTCTGGACA AGTGGGAGGTTCATGTTTGCTTTCTGGACA AGTTGGAGGCTCATGTTTGCTTTCTGGACA	4	0.9939393939393939	ACGGTGCCATGCAAAAGGAGAGTGATGA ATGGTGCCATGCAACAGGAGAGTGATGA GTGATTACATTAAGCTAAATGGCCCTCT TGGTGCTATGCAGAATGAGAGTGATGAA	{3503} {3503} {3527} {3504}
7.2095267230863795	8575	8758	183	8575	3	0.996969696969697	CACTCAAAGGTGGTAAGGTTGTTAGTACGT CACTCAAGGGTGGTAAGATTGTTAGTACTT CACTTAAGGGTGGTAAAGTCATTAGCACTT	8728	5	0.996969696969697	AAAGCCATCCAAGATGGTGTCACTCGTGAC AAAGCCATCCAGGATGGCGTCACTCGTGAC AAAGCCATTCAGGACGGTGTCACTCGTGAT AAAGCCATTCAGGATGGTGTCACTCGTGAC AAAGCTATCCAGGACGGTGTCACTCGTGAC	3	0.990909090909091	AACTTATGCTTAAGGCCACATTATTGTG TAAATTTATGCTGAAAGTCACACTTTTG TACACTCATTGTCTGTTCATGATGGTTA	{8611} {8609} {8678}
7.262275799801318	4682	4887	205	4682	5	0.996969696969697	CTGCATGCGCTCTCTTAAAGCTCCTGCTGT CTGTATGCGCTCCCTCAAGGCACCTGCTGT CTGTATGCGTTCTCTCAAAGCTCCTGCTGT CTGTATGCGTTCTCTTAAAGCTCCTGCCGT TTGTATGCGCTCTCTTAAAGCTCCTGCTGT	4857	3	0.996969696969697	TTAGGTGTTGAATTTCTCAAGCGTGGAGAT TTAGGTGTTGAATTTCTTAAGCGTGGGGAT TTAGGTGTTGAATTTCTTAAGCGTGGTGAC	3	0.9878787878787879	CATAGAGACCATCTCCCTTGCGGGTACG CTTCGTCTTCCAAGACACCTGAGGAGTA TGTCAGTATCATCGCCAGATGCTGTTAC	{4793} {4762} {4714}
7.358988527362399	7673	7782	109	7673	5	1.0	GCACTGGTAGTACATTCATTAGTGATGAAG GCGCTGGTAGTACTTTCATTAGCGACGAAG GTACTGGTAGTACTTTCATTAGCGACGAAG GTGCTGGCAGTACATTCATTAGTGATGAAG GTGCTGGTAGTACTTTCATTAGCGATGAAG	7752	4	0.996969696969697	CCAGTCATCGTATATTGTTGATAGTGTTGC CCAGTCCTCGTATGTCGTTGATAGTGTTGC CCAGTCTGCATATGTCGTGGATAGCGTTAC CCAGTCTTCTTATGTTGTTGATAGTGTTGC	1	1.0	CTCGTGATTTGTCACTCCAGTTTAAAAG	{7706}
7.373375799801318	8399	8604	205	8399	5	1.0	CGCTCAAGTAGCAAAAAGTCACAACGTTTC TGCCCAAGTAGCAAAAAGTCACAACATCTC TGCCCAAGTAGCAAAAAGTCACAATGTCGC TGCCCAAGTAGCAAAAAGTCACAATGTTTC TGCTCAAGTAGCAAAGAGTCACAATGTTTC	8574	3	0.996969696969697	TCACTCAAAGGTGGTAAGGTTGTTAGTACG TCACTCAAGGGTGGTAAGATTGTTAGTACT TCACTTAAGGGTGGTAAAGTCATTAGCACT	4	0.9939393939393939	AATGTAAAAGATTATATGTCTCTGTCAG AGACTATATGTCATTGTCTGAACAGTTG GACTTACCTGTGCTACTACTAGACAGGT TATATGTCTTTATCTGAACAGCTGCGTA	{8439} {8447} {8521} {8451}
7.401794263681199	9506	9594	88	9506	4	0.996969696969697	GTGCATTTGGTGAGTACAACCATGTTGTAG GTGCGTTTGGTGAGTACAACCATGTTGTTG GTGCTTTTGGTGAGTACAACCATGTTGTTG GTGTTTTTGGTGAGTACAACCATGTTGTTG	9564	5	0.996969696969697	TTTCACTATACTCTGTCTGGCACCAGCTTA TTTCACTATACTCTGTCTGGCACCTGCTTA TTTCACTATACTCTGTCTGGTACCAGCTTA TTTCACTATACTCTGTTTGGCACCTGCCTA TTTTACTATACTCTGCCTGGCACCTGCTTA	3	0.990909090909091	CCGCTAATGCATTGCTGTTTCTAATGTC CTGCTAATGCACTTTTGGTTTTGATGTC CTGCTAATGCACTTTTGTTTTTGATGTC	{9536} {9536} {9536}
7.428116028494806	4860	5006	146	4860	3	0.996969696969697	GGTGTTGAATTTCTCAAGCGTGGAGATAAG GGTGTTGAATTTCTTAAGCGTGGGGACAAG GGTGTTGAATTTCTTAAGCGTGGTGACAAA	4976	5	0.996969696969697	CCCTGCGGGAGGTTAAGACTATAAAAGTGT CCCTTCGTGAGGTTAAGACTATTAAGGTAT CTCTTCGCGAGGTTAAGACTATTAAAGTGT CTCTTCGTGAGGTTAAGACTATTAAGGTGT CTCTTCGTGAGGTTAGGACTATTAAAGTGT	6	0.996969696969697	GATGGTGAGGTTCAGCCACTCGACAAGC GGTTCTTTCACTTGACAAACTAAAGAGT TGGTGAGGTTCTCCCACTTGACAAGCTC TTCCACCTTGACGGCGAGGTTATTCCAC TTCCATCTTGACGGTGAGGTTCTCCCAC TTCCATCTTGATGGAGAGGTTCTCTTGC	{4933} {4941} {4935} {4924} {4924} {4924}
7.4600219161711365	24942	25192	250	24942	5	0.996969696969697	AGGCAAAGCACACTTCCCGCGTGAAGGTGT AGGCAAAGCATACTTCCCGCGTGAAGGTGT AGGCAAAGCATACTTCCCTCGTGAAGGTGT AGGCAAAGCTTATTTCCCTCGTGAAGGTGT AGGTAAGGCATACTTCCCTCGTGAAGGTGT	25162	3	0.996969696969697	AATCACACATCACCAGATGTTGATCTCGGC AATCACACATCACCTGATGTTGATCTTGGC AATCATACATCACCAGATGTTGATCTTGGC	4	0.990909090909091	TATCTAATGGCACTTCGTGGTTTATTAC TATCTAATGGCAGTTTTTGGTTTATTAC TTGTATCTAATGGCACTTCTTGGTTCAT TTGTGTTTAATGGCACTTCTTGGTTTAT	{24977} {24977} {24974} {24974}
7.626843765448655	7673	7846	173	7673	5	1.0	GCACTGGTAGTACATTCATTAGTGATGAAG GCGCTGGTAGTACTTTCATTAGCGACGAAG GTACTGGTAGTACTTTCATTAGCGACGAAG GTGCTGGCAGTACATTCATTAGTGATGAAG GTGCTGGTAGTACTTTCATTAGCGATGAAG	7816	4	0.996969696969697	AAGGCTGGCCAAAAGACTTATGAGAGGCAC AAGGCTGGTCAAAAGACCTATGAGAGACAT AAGGCTGGTCAAAAGACTTATGAGAGACAC AAGGCTGGTCAGAAGACTTACGAGAGACAC	1	1.0	CTCGTGATTTGTCACTCCAGTTTAAAAG	{7706}
7.670188504066714	7818	8061	243	7818	4	0.996969696969697	GGCTGGCCAAAAGACTTATGAGAGGCACCC GGCTGGTCAAAAGACCTATGAGAGACATCC GGCTGGTCAAAAGACTTATGAGAGACACCC GGCTGGTCAGAAGACTTACGAGAGACACCC	8031	4	0.996969696969697	CAGACGTTGGAGATAGTACTGAAGTTTCCG CAGATGTTGGAGATAGTACTGAAGTTTCTG CAGATGTTGGTGATAGCACTGAGGTTTCTG CGGATGTTGGTGATAGTACCGAGGTTTCTG	6	0.9848484848484849	CCTATTCTGTTGCTTGACCAATCTCTCG GCAAGTCCAAATGGGACGAGTCTGCTGC GCAAGTCCAAGTGCGAAGAGTCTGCCGC TCCAAATGTGAGGAGTCTGCCGCTAAAT TGCGACGAGTCTGCTGCTAAGTCTGCAT TGTGACGAGTCAGCTGCAAAGTCTGCAT	{8000} {7932} {7932} {7937} {7943} {7943}
7.730216373031191	4976	5192	216	4976	5	0.996969696969697	CCCTGCGGGAGGTTAAGACTATAAAAGTGT CCCTTCGTGAGGTTAAGACTATTAAGGTAT CTCTTCGCGAGGTTAAGACTATTAAAGTGT CTCTTCGTGAGGTTAAGACTATTAAGGTGT CTCTTCGTGAGGTTAGGACTATTAAAGTGT	5162	4	0.996969696969697	GCGATGACACACTGCGTAGTGAAGCTTTTG GTGATGACACACTACGTAGTGAAGCTTTCG GTGATGACACACTGCGTAGTGAAGCATTTG GTGATGATACACTACGTAGTGAAGCTTTTG	1	0.9878787878787879	TCATGAGGGTAAGACTTTCTTTGTACTA	{5130}
7.757211090344212	9080	9260	180	9080	5	0.996969696969697	GCAAACCTGTGCCATATTGTTATGACACTA GTAAACCTGTGCCGTACTGCTACGACACTA GTAAGCCGGTGCCATACTGTTATGACACAA GTAAGCCTGTGCCATACTGTTACGACACTA GTAAGCCTGTGCCATATTGTTATGACACTA	9230	4	1.0	CAACTTTTGATGCAGAGTACTGCCGTCATG CAACTTTTGATGCGGAGTACTGTAGGCATG CAACTTTTGATGCTGAGTACTGTAGACATG CAACTTTTGATGCTGAGTATTGCAGACATG	2	0.9939393939393939	ACTTGAGGGTTCTATTTCTTATAGTGAA CTAGAGGGTTCTATTTCTTATAGTGAGC	{9114} {9115}
7.783135466635868	9347	9591	244	9347	5	1.0	GAGTATTCTGTGGTGTTGATGCAATGAATC GAGTCTTTTGTGGTGTTGATGCCATGAATC GAGTTTTCTGTGGAGTCGATGCTATGAATC GAGTTTTCTGTGGTGTCGATGCTATGAACC GAGTTTTCTGTGGTGTTGATGCGATGAATC	9561	4	0.996969696969697	GTCTTTCACTATACTCTGCCTGGCACCAGC GTCTTTCACTATACTCTGTCTGGCACCAGC GTCTTTCACTATACTCTGTCTGGCACCTGC GTCTTTCACTATACTCTGTCTGGTACCAGC	1	0.996969696969697	ATTATTGCCATATTGGTGACTTGTGCTG	{9454}
7.790029642842771	885	1133	248	885	4	1.0	TGGCCCAGATGGCTACCCCCTTGAATGCAT TGGCCCAGATGGGTACCCTCTTGATTGCAT TGGCCCGGATGGGTATCCTCTTGAATGCAT TGGCCCTGATGGGTATCCTCTTGACTGCAT	1103	5	0.996969696969697	TTGACACCTTCAAAGGGGAATGCCCAAAGT TTGACACCTTTAAAGGGGAATGCCCGAAGT TTGACACGTTTAAAGAGGAATGCCCGAAGT TTGACACTTTCAAAGAGGAATGTCCGAAGT TTGACACTTTCAAAGGGGAATGCCCAAAGT	1	0.996969696969697	GCGGGCAAGTCAATGTGCACTCTTTCCG	{934}
7.8089083105030115	25648	25849	201	25648	4	0.996969696969697	TCCCTTTCGGATGGCTTATTGTTGGCGTTG TCCCTTTCGGATGGCTTGTTATTGGCGTTG TCCCTTTCGGATGGCTTGTTGTTGGCGTTG TCTCTTTCCGATGGCTTGTTGTTGGCGTTG	25819	5	0.996969696969697	CTGCAGGTATGGAGGCGCAATTTTTGTACC CTGCCGGCATGGAAGCACAATTCTTGTACA CTGCTGGCATGGAGGCACAATTTTTGTACA CTGCTGGCATTGAGGTACAATTCTTGTACA CTGCTTGCATGGAAGCACAATTCTTGTACA	2	0.9939393939393939	AGCTAGCCCTTTATAAGGGCTTCCAGTT TCAAAGCGCTTCCAAAGTGATTGCGCTT	{25735} {25694}
7.809864845367944	4147	4307	160	4147	5	0.996969696969697	AGTAGGTGATGTCATCACTAGTGGTGATAT AGTGGGTGATGTCATCACTAGTGGTGACAT GGTAGGTGATGTTATCACTAGTGGTGATAT TGTAGGTGATGTCATCAGTAGTGGTGACAT TGTTGGTGATGTCATCACTAGTGGTGACAT	4277	4	0.996969696969697	CCCGGACAAGGATGTGCTGGTTATACACTC CCCGGTCAAGGTTGTGCTGGTTATACACTT CCTGGACAAGGATGTGCTGGCTATACACTC CCTGGACAAGGATGTGCTGGTTATACACTT	3	0.9848484848484849	ACCTGCGTTGTAATACCTTCTAAGAAGG ACTTGTGTCATAATACCTGCTAAGAAGT AGCTTTGAAGAAAGTGCCAGTTGATGAG	{4178} {4178} {4234}
7.841316373031191	20726	20942	216	20726	4	1.0	AAAACTACAAGCAAGTCAAGCGTGGCAACC AAAATTACAAGCAAGTCAGGCATGGCAACC AAAATTACAGGCAAGTCAAGCATGGCAACC TAAATTACAAGCAAGTCAAGCGTGGCAACC	20912	5	0.996969696969697	TAGCTGTACCCTACAACATGAGAGTTATTC TAGCTGTGCCATACAATATGAGAGTTATCC TAGCTGTGCCTTACAACATGAGAGTCATAC TAGCTGTGCCTTATAACATGAGAGTGATAC TGGCTGTACCTTACAACATGAGAGTTATAC	2	1.0	CTGTCATACCAAAGGGAATAATGATGAA TTGTATAAGATGCAAAGAATGCTTCTTG	{20837} {20775}
7.870746828807646	5199	5430	231	5199	5	0.996969696969697	CCACACTATCGATGAGAGTTTTCTTGGTAG CCACACTCTCGACGAGAGTTTTCTCGGTAG CCACACTCTGGATGAGAGTTTTCTTGGTAG CCACACTCTTGATGAGAGTTTCCTTGGTAG CCATACTCTTGATGAGAGTTTTCTTGGTAG	5400	4	0.996969696969697	CCCGTGCTGGTGATGCTGCTAACTTTTGTG CTCGTGCCGGTGATGCTGCCAACTTTTGTG CTCGTGCTGGTGATGCAGCCAATTTTTGTG CTCGTGCTGGTGATGCTGCTAATTTTTGTG	2	0.9939393939393939	AGAAGTGGAAGTTTCCTCAGGTTGGTGG GTCTAGTGTTTTATTAGCACTTCAACAG	{5256} {5323}
7.888965756109887	9063	9304	241	9063	4	0.996969696969697	CTTTAAGGATGCTATGGGTAAGCCTGTGCC TTTCAAAGATGCTATGGGTAAGCCTGTGCC TTTTAAGGATGCTATGGGCAAACCTGTGCC TTTTAAGGATGCTATGGGTAAGCCTGTGCC	9274	5	1.0	TCAGAAGCTGGTATTTGCCTGTCTACTAGT TCAGAAGCTGGTATTTGCTTATCTACCAGT TCAGAAGCTGGTATTTGCTTGTCTACTAGC TCAGAAGTAGGTATTTGCCTATCTACCAGT TCAGAAGTTGGTGTGTGCTTATCTACTAGC	2	0.9939393939393939	ACTTGAGGGTTCTATTTCTTATAGTGAA CTAGAGGGTTCTATTTCTTATAGTGAGC	{9114} {9115}
7.926757335320482	1872	2076	204	1872	4	0.996969696969697	AGGAGCTTGGAACATTGGACAACAGCGGTC AGGAGCTTGGAACATTGGACAGCAAAAATC AGGTGCTTGGAACATTGGACAACAAAAATC AGGTGCTTGGAACATTGGACAACAGAGATC	2046	5	0.996969696969697	ATCATTGCGTCTTATCGATGCCATGGTTTA GTCACTGCGTCTTGTTGATGCAATGGTGTG GTCATTACGTCTTGTCGACGCCATGGTTTA GTCATTGCGTCTTGTTGATGCCATGGTTTA TTCATTGCGTCTTGTTGATGCCATGACTTA	3	0.990909090909091	CCACTGTGCGGTTTCCCCTCACAGGCTG CCACTGTGTGGTTTTCCCTCACAGGCTG TGTGGATTTCCATCACAGGCTGCTGGTG	{1912} {1912} {1918}
7.9311790169831395	8299	8505	206	8299	4	0.996969696969697	GTGACAGTTGTAACAACTTTATGCTCACCT GTGACAGTTGTAACAATTTCATGCTCACCT GTGACAGTTGTAACCACTTCATGCTCACCT GTGACAGTTGTAATAACTTCATGCTCACCT	8475	5	0.996969696969697	CGCAAGCAAATTCGCAGTGCTGCCAAAAAG CGCAAGCAAATTCGTAGCGCTGCCAAAAAG CGCAAGCAAATTCGTAGTGCTGCTAAAAAG CGTAAACAAATTCGTAGTGCGGCTAAGAAG CGTAAACAAATTCGTAGTGCTGCCAAGAAG	3	0.9939393939393939	AATGTTTCACTCATCTGGAATGTAAAAG AGACTATATGTCATTGTCTGAACAGTTG TTTCGCTGGTTTGGAACGTCAAGGACTA	{8421} {8447} {8425}
7.983716028494806	1808	2040	232	1808	5	0.996969696969697	AGACATTTAAGGACATTGTTGAGTCCTGCG AGACCTTCAAAGCCATTGTTGAATCCTGTG AGTCTTTCAAAACCATTGTTGAGTCCTGCG AGTCTTTCAAATCCATTGTTGAGTCTTGCG AGTCTTTTAAAGCCATTGTTGAGTCCTGCG	2010	4	0.996969696969697	AGCAGCTGTCACCACTCTTGATGGTATTTC AGCAGCTGTCACCATACTTGATGGTATTTC AGCAGCTGTCACCATCCTTGGTGACATTTC AGCAGCTGTTACCATCCTTGATGGTATTTC	3	0.9848484848484849	CCACTGTGTGGTTTTCCCTCACAGGCTG GTAACTTTAAAGTTACGCGTGGCAGAGC TGTGGATTTCCATCACAGGCTGCTGGTG	{1912} {1838} {1918}
7.994707968360733	1808	1957	149	1808	5	0.996969696969697	AGACATTTAAGGACATTGTTGAGTCCTGCG AGACCTTCAAAGCCATTGTTGAATCCTGTG AGTCTTTCAAAACCATTGTTGAGTCCTGCG AGTCTTTCAAATCCATTGTTGAGTCTTGCG AGTCTTTTAAAGCCATTGTTGAGTCCTGCG	1927	4	0.996969696969697	CCATCACAGGCCGCCAGTGTCATTAGAGCA CCATCACAGGCTGCTGGTGTTATTAGATCT CCCTCACAGGCTGCTGGTGTTATCAGATCA CCCTCACGGGCTGCCAGTGTCATTAGATCA	5	0.9878787878787879	CAAGGGCAAGCCTGTGAAAGGTGCTTGG GTAACTTTAAAGTTACGCGTGGCAGAGC GTTACCAAGGGAAAGCCCGTAAAAGGAG TCCAAGGAGCTTGGAACATTGGCCAGCA TTGGAACATTGGACAACAGAGATCCATC	{1854} {1838} {1849} {1868} {1878}
8.01222964284277	4188	4436	248	4188	4	0.996969696969697	TAATACCCTCCAAAAAGGCTGGTGGCACTA TAATACCTGCCAAGAAGGCTGGCGGTACTA TAATACCTGCTAAGAAGGCTGGTGGTACTA TAATACCTGCTAAGAAGTCGGGTGGGACTA	4406	5	0.996969696969697	ATGGAACCTACGTGAAATGCTTGCTCATGC CTGGAATCTAAGAGAAATGCTTGCACATGC CTGGAATTTAAGAGAGATGCTTGCCCATGC CTGGAATTTAAGGGAAATGCTTGCTCATGC CTGGAATTTGAGAGAAATGCTTGCTCATGC	3	0.990909090909091	AAAATGCAAATCTGCACTGTATGTTCTA GAAATGCAAATCTGCATTTTATGTACTA TAACTACATATCCCGGACAAGGATGTGC	{4331} {4331} {4266}
8.040075799801318	8031	8236	205	8031	4	0.996969696969697	CAGACGTTGGAGATAGTACTGAAGTTTCCG CAGATGTTGGAGATAGTACTGAAGTTTCTG CAGATGTTGGTGATAGCACTGAGGTTTCTG CGGATGTTGGTGATAGTACCGAGGTTTCTG	8206	5	0.996969696969697	CAGCCCGTCAAGGTGTTGTAGACACTGATG CATCCCGTCAAGGTGTTGTAGATACTGATG CCGCACGCCAAGGTGTCGTTGATACTGATG CTGCCCGACAAGGTGTTGTTGATACCGATG CTGCCCGTCAAGGTGTTGTTGATACTGATG	4	0.9878787878787879	AGCACTTGTTGCAACTGCCCATAGCGAG CATGGAAAAACTTAAGGCACTTGTTGTT GTGTCCCTATGGAAAAACTTAGGGCACT TCAGCAACTTTTAGTGTTCCTATGGAGA	{8128} {8113} {8106} {8093}
8.28491812834518	4628	4743	115	4628	5	0.996969696969697	CACAATGCCAATTGGTTATGTGACACATGG CACAATGCCGATAGGTTATGTGACACATGG CACTATGCCTATTGGTTATGTGACACATGG TACTATGCCAATTGGTTATGTGACACATGG TACTATGCCCATAGGTTATGTGACACATGG	4713	5	0.996969696969697	GTATCAGTTTCTTCACCCGATGCTGTTACT GTGTCAGTATCATCACCAGATGCTGTTACT GTGTCAGTATCATCACCTGATGCCGTCACT GTGTCAGTTTCTTCACCAGATGCTGTCACT GTTTCAGTGTCTTCACCAGACGCAGTTACT	3	0.9939393939393939	CTGCGCGCTGTATGCGTTCTCTTAAAGC TAACCTCGAAGAGACCGCGCGCTGTATG TTTTAATCTTGAAGAAGCAGCGCGCTGC	{4675} {4661} {4658}
8.317116028494807	9080	9226	146	9080	5	0.996969696969697	GCAAACCTGTGCCATATTGTTATGACACTA GTAAACCTGTGCCGTACTGCTACGACACTA GTAAGCCGGTGCCATACTGTTATGACACAA GTAAGCCTGTGCCATACTGTTACGACACTA GTAAGCCTGTGCCATATTGTTATGACACTA	9196	5	1.0	AACACCTACCTAGAAGGTTCTGTTAGAGTG AACACTTACCTGGAGGGTTCTGTTAGAGTA AACACTTACCTTGAGGGGTCTGTTAGAGTA AACACTTACTTGGAAGGTTCTGTTAGAGTG AACGCATACTTAGAAGGTTCTGTTAGAGTG	2	0.9939393939393939	ACTTGAGGGTTCTATTTCTTATAGTGAA CTAGAGGGTTCTATTTCTTATAGTGAGC	{9114} {9115}
8.352934243325825	4530	4658	128	4530	5	1.0	GGAATCGTGGATTACGGTGTCCGGTTCTTC GGAATCGTTGACTATGGTGTTCGGTTCTTT GGAATTGTTGACTATGGTGTCCGATTCTTC GGCATCGTTGACTATGGTGTCCGATTCTTC GGCATTGTTGACTATGGAGTCCGATTCTTC	4628	5	0.996969696969697	CACAATGCCAATTGGTTATGTGACACATGG CACAATGCCGATAGGTTATGTGACACATGG CACTATGCCTATTGGTTATGTGACACATGG TACTATGCCAATTGGTTATGTGACACATGG TACTATGCCCATAGGTTATGTGACACATGG	3	0.990909090909091	TCTATCATTATGAAGCTGAACTCTCTAA TTCTATACTAGCAAGGAGCCTGTAGCTT TTTTACACTAGTAAAGAGCCTGTAGCTT	{4587} {4560} {4560}
8.442789758004453	4628	4778	150	4628	5	0.996969696969697	CACAATGCCAATTGGTTATGTGACACATGG CACAATGCCGATAGGTTATGTGACACATGG CACTATGCCTATTGGTTATGTGACACATGG TACTATGCCAATTGGTTATGTGACACATGG TACTATGCCCATAGGTTATGTGACACATGG	4748	5	0.996969696969697	CAATGGATACCTCACATCATCTTCAAAGAC TAATGGATACCTCACTTCGTCATCAAAGAC TAATGGATACCTTACATCGTCTTCGAAGAC TAATGGGTACCTCACGTCATCTTCAAAGAC TAATGGTTACCTCACTTCGTCTTCCAAGAC	3	0.9939393939393939	CTGCGCGCTGTATGCGTTCTCTTAAAGC TAACCTCGAAGAGACCGCGCGCTGTATG TTTTAATCTTGAAGAAGCAGCGCGCTGC	{4675} {4661} {4658}
8.460121916171136	4976	5226	250	4976	5	0.996969696969697	CCCTGCGGGAGGTTAAGACTATAAAAGTGT CCCTTCGTGAGGTTAAGACTATTAAGGTAT CTCTTCGCGAGGTTAAGACTATTAAAGTGT CTCTTCGTGAGGTTAAGACTATTAAGGTGT CTCTTCGTGAGGTTAGGACTATTAAAGTGT	5196	5	0.996969696969697	CTACCACACTCTCGATGAGAGTTTTCTTGG CTACCACACTCTTGATGAGAGTTTCCTTGG CTACCATACTCTTGATGAGAGTTTTCTTGG TTACCACACTCTCGACGAGAGTTTTCTCGG TTACCATACTCTCGATGAGAGTTTTCTTGG	1	0.9878787878787879	TCATGAGGGTAAGACTTTCTTTGTACTA	{5130}
8.501236002980722	8885	9053	168	8885	5	0.996969696969697	TTGGCTTCATAGTGCCTGGCCTACCGGGTA TTGGCTTCATCGTGCCTGGATTACCTGGTA TTGGCTTTATAGTGCCTGGCTTACCAGGTA TTGGTTTCATAGTGCCTGGCTTACCGGGTA TTGGTTTCATAGTGCCTGGTTTACCTGGTA	9023	5	0.996969696969697	TTGCCACTTCTGCTTGTGTCTTAGCAGCTG TTGCTACCTCTGCTTGCGTTCTTGCTGCTG TTGCTACTTCTGCTTGCGTCTTGGCTGCGG TTGCTACTTCTGCTTGCGTTTTGGCTGCTG TTTCCACTTCTGCTTGCGTTCTTGCTGCTG	3	1.0	CCATCTAAACTCATTGAGTATAGTGATT CTGTTCTGAGAGCAATCAATGGTGACTT GTGCTGAGAGCAATCAATGGTGACTTCT	{8995} {8915} {8917}
8.540309836406474	4530	4712	182	4530	5	1.0	GGAATCGTGGATTACGGTGTCCGGTTCTTC GGAATCGTTGACTATGGTGTTCGGTTCTTT GGAATTGTTGACTATGGTGTCCGATTCTTC GGCATCGTTGACTATGGTGTCCGATTCTTC GGCATTGTTGACTATGGAGTCCGATTCTTC	4682	5	0.996969696969697	CTGCATGCGCTCTCTTAAAGCTCCTGCTGT CTGTATGCGCTCCCTCAAGGCACCTGCTGT CTGTATGCGTTCTCTCAAAGCTCCTGCTGT CTGTATGCGTTCTCTTAAAGCTCCTGCCGT TTGTATGCGCTCTCTTAAAGCTCCTGCTGT	3	0.990909090909091	TCTATCATTATGAAGCTGAACTCTCTAA TTCTATACTAGCAAGGAGCCTGTAGCTT TTTTACACTAGTAAAGAGCCTGTAGCTT	{4587} {4560} {4560}
8.569530266661923	8899	9148	249	8899	5	0.996969696969697	CCTGGATTACCTGGTACTGTGTTAAGAACA CCTGGCCTACCGGGTACTGTTTTGCGAGCA CCTGGCTTACCAGGTACTGTGTTGAGAGCA CCTGGCTTACCGGGTACTGTGCTGAGAGCA CCTGGTTTACCTGGTACTGTTTTGAGAGCA	9118	5	0.996969696969697	GAAGGTTCCATTTCTTACAGTGAACTCCGC GAGGGTTCTATTTCTTACAGTGAGCTGCGT GAGGGTTCTATTTCTTATAGTGAACTCCGT GAGGGTTCTATTTCTTATAGTGAGCTTCGT GAGGGTTCTATTTCTTATAGTGAGTTGCGT	2	0.9939393939393939	CCATCTAAACTCATTGAGTATAGTGATT TTTTAAGGATGCTATGGGCAAACCTGTG	{8995} {9063}
8.569530266661923	8977	9226	249	8977	5	0.996969696969697	GGCAACATTTGCTACACACCATCAAAACTT GGCAACATTTGCTACACACCATCTAAACTC GGCAACATTTGCTACACACCTTCCAAACTC GGCAATATTTGCTACACACCTTCTAAACTC GGTAACATCTGCTACACACCATCAAAACTT	9196	5	1.0	AACACCTACCTAGAAGGTTCTGTTAGAGTG AACACTTACCTGGAGGGTTCTGTTAGAGTA AACACTTACCTTGAGGGGTCTGTTAGAGTA AACACTTACTTGGAAGGTTCTGTTAGAGTG AACGCATACTTAGAAGGTTCTGTTAGAGTG	2	0.996969696969697	AGGATGCTATGGGTAAGCCTGTGCCATA CTAGAGGGTTCTATTTCTTATAGTGAGC	{9068} {9115}
8.600067195022639	2731	2938	207	2731	5	0.996969696969697	CCAGGATTGTTAGCAACAAACAATGTCTTC CCAGGCTTATTAGCTACAAACAATGTCTTC CCTGGCTTGTTAGCAACAAACAATGTCTTT CCTGGTTTACTGGCTACAAACAATGTCTTT CCTGGTTTATTAGCCACAAACAATGTCTTC	2908	5	0.996969696969697	GTGGAGTCAGGTACAGAAGTGTCTGAATTT GTTGAATCCGGTACAGAGGTCAATGAATTC GTTGAATCCGGTACAGAGGTTACTGAATTC GTTGAATCCGGTACCGAAGTTACTGAGTTT GTTGAGTCTGGTACTGAGGTTACTGAATTC	3	0.996969696969697	AAGGTGTGACTTTTGGAGAGGACACTGT AGAATCACATTTGAGCTTGATGAACGTG GTCTAAAAGGAGGTGCACCAGTTAAGGG	{2786} {2842} {2762}
8.610789493487164	4531	4743	212	4531	5	1.0	GAATCGTGGATTACGGTGTCCGGTTCTTCT GAATCGTTGACTATGGTGTTCGGTTCTTTT GAATTGTTGACTATGGTGTCCGATTCTTCT GCATCGTTGACTATGGTGTCCGATTCTTCT GCATTGTTGACTATGGAGTCCGATTCTTCT	4713	5	0.996969696969697	GTATCAGTTTCTTCACCCGATGCTGTTACT GTGTCAGTATCATCACCAGATGCTGTTACT GTGTCAGTATCATCACCTGATGCCGTCACT GTGTCAGTTTCTTCACCAGATGCTGTCACT GTTTCAGTGTCTTCACCAGACGCAGTTACT	3	0.990909090909091	ACTTGTTACTATGCCCATAGGTTATGTG CTGCGCGCTGTATGCGTTCTCTTAAAGC GTGGCTTCTATTATTACGAAGCTGAATT	{4622} {4675} {4581}
8.664989758004454	1926	2076	150	1926	5	0.996969696969697	CCCCTCACAGGCTGCTGGTGTTATTAGATC TCCATCACAGGCAGCCAGTGTCATTAGAGC TCCATCACAGGCTGCTGGTGTTATTAGATC TCCCTCACAGGCTGCTGGTGTTATCAGATC TCCCTCACGGGCTGCCAGTGTCATTAGATC	2046	5	0.996969696969697	ATCATTGCGTCTTATCGATGCCATGGTTTA GTCACTGCGTCTTGTTGATGCAATGGTGTG GTCATTACGTCTTGTCGACGCCATGGTTTA GTCATTGCGTCTTGTTGATGCCATGGTTTA TTCATTGCGTCTTGTTGATGCCATGACTTA	5	0.9939393939393939	AATTTTCTCTCGCACACTGGATGCAGCA ATTCTATCCCAGATTTACAAAGAGCAGC CCAGACCTGCAGAAAGCAGCTGTTACCA CTTGGTGCAGCAAACCACTCAATTCCTG TTCCTGATTTGCAAAGAGCAGCTGTCAC	{1956} {1988} {1996} {1972} {1994}
8.677219948987032	4531	4778	247	4531	5	1.0	GAATCGTGGATTACGGTGTCCGGTTCTTCT GAATCGTTGACTATGGTGTTCGGTTCTTTT GAATTGTTGACTATGGTGTCCGATTCTTCT GCATCGTTGACTATGGTGTCCGATTCTTCT GCATTGTTGACTATGGAGTCCGATTCTTCT	4748	5	0.996969696969697	CAATGGATACCTCACATCATCTTCAAAGAC TAATGGATACCTCACTTCGTCATCAAAGAC TAATGGATACCTTACATCGTCTTCGAAGAC TAATGGGTACCTCACGTCATCTTCAAAGAC TAATGGTTACCTCACTTCGTCTTCCAAGAC	3	0.990909090909091	ACTTGTTACTATGCCCATAGGTTATGTG CTGCGCGCTGTATGCGTTCTCTTAAAGC GTGGCTTCTATTATTACGAAGCTGAATT	{4622} {4675} {4581}
8.682321916171135	2511	2761	250	2511	5	0.996969696969697	GCCACTTAAGGCACCTAAAGACGTCACCTT GCCTCTTAAGGCACCAAAAGAAGTAACCTT GCCTCTTAAGGCACCAAAAGAAGTCACCTT GCCTCTTAAGGCTCCTAAGGAAGTCACCTT GCCTTTGAAGGCACCTAAAGAAGTCACTTT	2731	5	0.996969696969697	CCAGGATTGTTAGCAACAAACAATGTCTTC CCAGGCTTATTAGCTACAAACAATGTCTTC CCTGGCTTGTTAGCAACAAACAATGTCTTT CCTGGTTTACTGGCTACAAACAATGTCTTT CCTGGTTTATTAGCCACAAACAATGTCTTC	3	0.9939393939393939	CTGTGTAAATGGCCTCATGCTCTTAGAG GTTGTTCTAAAAAATGGTGAACTCGAGG TTGTATCAATGGCCTCATGCTCTTAGAG	{2670} {2587} {2670}
