cost	target-start	target-end	target-length	left-primer-start	left-primer-num-primers	left-primer-frac-bound	left-primer-target-sequences	right-primer-start	right-primer-num-primers	right-primer-frac-bound	right-primer-target-sequences	num-guides	total-frac-bound-by-guides	guide-target-sequences	guide-target-sequence-positions
4.331389758004454	26751	26991	240	26751	2	0.9285714285714286	CTTTAACATTGCTTATCATGGCAGAGAACG CTTTAATTTTAGCCATGTCAGCTGACAACG	26961	1	0.9464285714285714	TGCTTGCTGCTGTTTACAGAATTAATTGGG	6	0.8214285714285714	AATCTAGTAATAGGTTTCATTTTCCTTG ATTACTGTTGAAGAGCTTAAGCAGCTCT ATTTCTAACATGGATTTGTCTTTTACAG CCATTTCTGTTGAGGAGCTTAAAAGACT GGACAATCTCCGTTGAGGAGCTTAAAAG GGACTATTTCCGTCGAGGAGCTTAAAAG	{26825} {26786} {26845} {26784} {26781} {26781}
4.44603196905215	26698	26940	242	26698	1	1.0	CTGATCTTCTGGTCTAAACGAACTAACTAT	26910	2	0.9821428571428571	TAAAGCTTGTTTTCCTCTGGCTCTTGTGGC TTAAGTTAATTTTCCTCTGGCTACTTTGGC	7	0.8928571428571429	AATCTAGTAATAGGTTTCATTTTCCTTG ATTACTGTTGAAGAGCTTAAGCAGCTCT ATTGCTTGTCATGGCAGAGAACGGGACA CCATTTCTGTTGAGGAGCTTAAAAGACT GAACTTTAATTTTAGCCATGTCAGCTGA GTGGAATCTAGTAATAGGATTCCTATTT TTATCATGGCTGAGAACGGGACTATTTC	{26825} {26786} {26758} {26784} {26748} {26821} {26763}
4.881601953228442	9298	9535	237	9298	1	0.9107142857142857	GAGGGTTCTGTTAGAGTAGTTACAACTTTT	9505	3	0.9107142857142857	GGTGCTTTAGACATATCAGCTTCAATTGTT GGTGCTTTAGATGTGTCTGCTTCAGTAGTG GGTGCTTTGGACATATCTGCATCTATTGTA	5	0.8035714285714286	ATAGAGCTCTACCTGGAGTATTTTGTGG ATTCAGAGTATTGTAGACATGGTACTTG GAGAGGTCAGAAGCTGGTATTTGCTTGT TACTTGTGAAAGGTCAGAAGTTGGTGTG TGATTATTATAGATCATTACCTGGTGTG	{9422} {9329} {9358} {9351} {9414}
4.894035466635868	26654	26898	244	26654	1	0.9285714285714286	CGTTTACTCACGTGTTAAAAATCTGAACTC	26868	3	0.9642857142857143	TACAATTTGCCTATGCCAACAGGAATAGGT TACAATTTGCCTATTCTAACCGGAACAGGT TACAGTTCGCCTATGCTAACAGGAATAGGT	5	0.8392857142857143	AATCTAGTAATAGGTTTCATTTTCCTTG ATTGCTTGTCATGGCAGAGAACGGGACA CCATTTCTGTTGAGGAGCTTAAAAGACT GAACTTTAATTTTAGCCATGTCAGCTGA TTATCATGGCTGAGAACGGGACTATTTC	{26825} {26758} {26784} {26748} {26763}
4.935340537842753	26698	26906	208	26698	1	1.0	CTGATCTTCTGGTCTAAACGAACTAACTAT	26876	3	0.9285714285714286	GCCTATGCTAACAGGAATAGGTTTCTGTAC GCCTATTCCAACCGGAACAGGTTTCTGTAT GCCTATTCTAATCGGAACAGGTTTTTGTAC	6	0.875	AATCTAGTAATAGGTTTCATTTTCCTTG ATTACTGTTGAAGAGCTTAAGCAGCTCT ATTGCTTGTCATGGCAGAGAACGGGACA CCATTTCTGTTGAGGAGCTTAAAAGACT GAACTTTAATTTTAGCCATGTCAGCTGA TTATCATGGCTGAGAACGGGACTATTTC	{26825} {26786} {26758} {26784} {26748} {26763}
5.002394696155047	26751	26940	189	26751	2	0.9285714285714286	CTTTAACATTGCTTATCATGGCAGAGAACG CTTTAATTTTAGCCATGTCAGCTGACAACG	26910	2	0.9821428571428571	TAAAGCTTGTTTTCCTCTGGCTCTTGTGGC TTAAGTTAATTTTCCTCTGGCTACTTTGGC	7	0.8571428571428571	AATCTAGTAATAGGTTTCATTTTCCTTG ATTACTGTTGAAGAGCTTAAGCAGCTCT ATTTCTAACATGGATTTGTCTTTTACAG CCATTTCTGTTGAGGAGCTTAAAAGACT GGAACCTAGTAATAGGATTCTTGTTTCT GGACAATCTCCGTTGAGGAGCTTAAAAG GGACTATTTCCGTCGAGGAGCTTAAAAG	{26825} {26786} {26845} {26784} {26823} {26781} {26781}
5.277189493487165	20363	20575	212	20363	2	0.9464285714285714	ACCCAGGAGTCAAATGGAAATTGATTTCTT GCCCAGATCACAAATGGAAACTGACTTCCT	20545	2	0.9464285714285714	TAGAGGATTTTATCCCTATGGATAGCACAG TAGAGGATTTTATTCCTATGGACAGTACAG	9	0.8928571428571429	AGAACGATATAAGCTAGATGGCTATGCT AGATTTTAGTCATGGACAGCTTGGTGGA ATTACATCTATTGATTGGACTTGCTAAG CATCTAATGATAGGTCTTGCCAAGAGAT GCGGACTGCATCTAATGATTGGTCTAGC GCGGACTTCATTTAATGATTGGTCTTGC TAAACGTTCAAAGGATTCGCCTCTCGAG TACAACGGTATAAGTTAGAGGGTTATGC TTTCAGTTATGGACAACTTGGCGGGTTG	{20417} {20465} {20492} {20496} {20488} {20488} {20516} {20416} {20468}
5.4015942636812	3530	3702	172	3530	2	0.9107142857142857	ACATGGTGGTGGTGTAGCAGGTGCACTCAA ACATGGTGGTGGTGTAGCTGGTGCTCTAAA	3672	3	0.9107142857142857	TGCCTTCATGTTGTTGGTCCTAATCTCAAC TGTATGCATGTTGTTGGCCCAAACCTAAAT TGTCTGCATGTTGTTGGACCTAACCTAAAT	5	0.8392857142857143	AATTGAGTCTGATGACTACATTGCCAGA ACTAATGGTGCTATGCAGAATGAGAGTG ATGGTCCTCTCACAGTGGGAGGTTCATG CCACTCACAGTAGGTGGTTCATGTTTGC TAGTTGGAGGTTCATGTTTGCTTTCTGG	{3584} {3567} {3613} {3618} {3625}
5.564201087828205	26751	26904	153	26751	2	0.9285714285714286	CTTTAACATTGCTTATCATGGCAGAGAACG CTTTAATTTTAGCCATGTCAGCTGACAACG	26874	3	0.9642857142857143	TCGCCTATGCTAACAGGAATAGGTTTCTGT TTGCCTATGCCAACAGGAATAGGTTTTTGT TTGCCTATTCTAACCGGAACAGGTTTTTGT	7	0.8571428571428571	AATCTAGTAATAGGTTTCATTTTCCTTG ATTACTGTTGAAGAGCTTAAGCAGCTCT ATTTCTAACATGGATTTGTCTTTTACAG CCATTTCTGTTGAGGAGCTTAAAAGACT GGAACCTAGTAATAGGATTCTTGTTTCT GGACAATCTCCGTTGAGGAGCTTAAAAG GGACTATTTCCGTCGAGGAGCTTAAAAG	{26825} {26786} {26845} {26784} {26823} {26781} {26781}
5.902630266661922	20363	20612	249	20363	2	0.9464285714285714	ACCCAGGAGTCAAATGGAAATTGATTTCTT GCCCAGATCACAAATGGAAACTGACTTCCT	20582	3	0.9285714285714286	TTACTTCATAACAGATGCACAAACAGGTTC TTACTTTATTACAGATGCACAAACAGGGTC TTATTTCATAACAGATGCTCAGACAGGTTC	8	0.8392857142857143	AGATTTTAGTCATGGACAGCTTGGTGGA ATTACATCTATTGATTGGACTTGCTAAG CATCTAATGATAGGTCTTGCCAAGAGAT GCGGACTTCATTTAATGATTGGTCTTGC GGCCAACTTGGTGGACTACATCTAATGA TAAACGTTCAAAGGATTCGCCTCTCGAG TACAACGGTATAAGTTAGAGGGTTATGC TTTCAGTTATGGACAACTTGGCGGGTTG	{20465} {20492} {20496} {20488} {20478} {20516} {20416} {20468}
6.010419948987033	28574	28821	247	28574	1	0.9464285714285714	CTTTTTAGCCTTTCTGCTATTCCTTGTTCT	28791	5	0.9107142857142857	CATGCCCTATACATTTCTACTCGAAATGGT CATGTCCAATACATTACTATTCGGACTGGT CATGTCCCACTGGTTATCAGCCAGAGTGGA CTTGTCCAATTCACTTCTACTCACGATGGT CTTGTCCTACTGGTTACCAACCAGAATGGA	3	0.875	AATTATGCTCATGATATTTTGGTTTGCT CATTGTTTTTGGACTCTTAACATCAGTG TCACTTGAACTCCAGGATATAGAAGAAA	{28604} {28693} {28629}
6.024114134296108	8650	8848	198	8650	3	0.9285714285714286	ATAACTACTAAAATCTCACTCAAGGGTGGT GTAACAACAAAGATAGCACTTAAAGGTGGT GTTACAACAAAAATAGCACTTAAGGGTGGT	8818	3	0.9107142857142857	AAAGCCATTCAGGATGGTGTCACTCGTGAC AAAGCTATCCAGGACGGTGTCACTCGTGAC AAAGCTATTGAAGATGGTGTCACACGTGAC	4	0.8571428571428571	AAATTTGTTACAAATTGGTTTAAGTACT ATACATTGTCTGCTCATGATGGTTATAC GGTTCAAACTTTTGCTGAAAGTCACACT TTCATTGTCTGTTCATGATGGTTACACA	{8680} {8771} {8696} {8772}
6.107503865708117	8649	8888	239	8649	3	0.9285714285714286	AGTAACAACAAAGATAGCACTTAAAGGTGG CATAACTACTAAAATCTCACTCAAGGGTGG CATAACTACTAAGATTTCACTTAAGGGTGG	8858	3	0.9464285714285714	ACGACAATTGCTTTGCTAATAAACACGTTG CAGATACTTGTTTTGCTAACAAACATGCTG CTGATGATTGTTTTGCAAACAAACATGCTG	4	0.8392857142857143	ATACATTGTCTGCTCATGATGGTTATAC GGTTCAAACTTTTGCTGAAAGTCACACT TAAATTTGTTACAAATTGGTTTAAGTAC TGCATTGTCTGTTCATGATGGTTACACA	{8771} {8696} {8679} {8772}
6.119801087828204	19964	20210	246	19964	3	0.9642857142857143	ACTCAACAATTTGGGTGTTGACATTGCTGC ACTCAATAATTTGGGTGTCGACATCGCTGC ACTCAATAATTTGGGTGTCGATATCGCTGC	20180	3	0.9285714285714286	AACAGAAGGTTCAGTTAAAGGTTTAACACC AACGGAAGGTTCAGTCAAGGGTTTAACACC AACTGAGGGTAATGTAAAAGGATTACAACC	4	0.8392857142857143	AGCTTATGTTTCTACAATAGGTGTCTGT CAAGAGAGAAGCACCAGCACATATGTCA GGGACAGGTAGACTTTTTCAGAAATGCT TGGTAGAGTTGAAGGACAGGTTGACTTA	{20030} {20015} {20135} {20123}
6.170379969342407	8240	8454	214	8240	5	0.9107142857142857	AAGCTGAACTTGCAAAGAATGTGTCTTTAG AGACTGAACTTGCTAAGAATGTGTCTTTAG ATAGCGAGCTGGCAAAGGGTGTAGCTTTAG ATAGTGAGCTAGCAAAGGGTGTGGCTTTAG ATAGTGAGTTGGCTAAGGGTGTTGCTTTGG	8424	1	0.9107142857142857	CAAAGTTGAAAACATGACGCCTAGAGATCT	5	0.8392857142857143	ATGGTGTCTTATCCACATTTATTTCAGC CCTTTCTACATTTGTGTCGGCTGCTCGT CTTTCAACATTTATCTCAGCAGCTCGTC GTGTCTCAAACTTTCTCACCATTCTGAT TTTGTGTCCGCAGCCCGTCAAGGTGTTG	{8270} {8277} {8278} {8349} {8287}
6.1944337616452865	8125	8351	226	8125	3	0.9107142857142857	GATGTTGGAGATAGTACTGAAGTTTCTGTT GATGTTGGTGACAGTGCAGAAGTAGCTGTT GATGTTGGTGATAGTACCGAGGTTTCTGTC	8321	3	0.9107142857142857	CTGATGTTGACACAAAGGATGTCATTGAAT CTGATGTTGATACAAAGGACGTCATTGAGT CTGATGTTGATACTAAGGACGTTGTGGAAT	5	0.8392857142857143	CCTTTCTACATTTGTGTCGGCTGCTCGT CTTGTTGCTACAGCACATAGTGAGTTGG TATCCACATTTGTTTCAGCTGCCCGTCA TCAACTTTTAACGTGCCTATGGATAAGT TTTGTGTCCGCAGCCCGTCAAGGTGTTG	{8277} {8224} {8279} {8188} {8287}
6.305533761645286	7166	7392	226	7166	4	0.9107142857142857	CTCCTTCTTATTGTAGTGGCGTTAGAGAAT TCCCTTCTTATTGTGGTGGTGTTAGAGATT TGCCGTCATACTGTACAAGTTACAGAGATG TTCCTTCTTATTGTGATGGCGTTAGAGAGT	7362	2	0.9821428571428571	AGCTGAGTGGTTTTTGGCATATATGTTGTT TGCAGAGTGGTGTTTGGCATATATTCTCTT	6	0.8392857142857143	CAGTGTTTGTTTAAGTGGATTAGATTCG CAGTGTTTGTTTAGGTGGATTAGACTCT TACTAATGTCACAACAACAGCTTACTGT TATAAGCTAGACCTGACATTTTTGGGTT TCTACGAGGGTTCTTTTCTATGCAGTGT TGTATATCAATTCCTCTAATGTCACCAT	{7254} {7254} {7209} {7330} {7232} {7196}
6.343719948987032	23361	23608	247	23361	3	0.9107142857142857	AATGCACCCGCTACAGTCTGTGGACCAAAA AATGCACCTGCTACAGTTTGTGGACCTAAA AATGGACCAGCTACTGTTTGTGGACCCAAA	23578	3	0.9285714285714286	CCTTTGGTGGTGTTAGTGTTATCACACCTG CTTTTGGTGGTGTAAGTGTAATAACACCTG CTTTTGGTGGTGTTAGTGTGATAACACCAG	6	0.8571428571428571	CACAAACATTAGAAATACTTGACATTTC CACTGATTCAGTTCGAGATCCGAAGACG TAATGGACTTAAAGGTACTGGTGTTTTG TACAACACTAGTTAAAGACAAATGTGTC TCTACACAACTAGTTAAGAACCAGTGTG TGACTGATTCTTCAAAGAGATTTCAGTC	{23542} {23522} {23435} {23396} {23394} {23461}
6.501136002980723	6968	7136	168	6968	3	0.9464285714285714	CACTTCCTACGACTATTGCTAAAAATAGTG CTATGCCAACCACTATAGCAAAGAATACTG CTATGCCAACTACTATAGCTAAAAATACGG	7106	4	0.9285714285714286	GCCTAGGTTCTTTAACCTATGTAACTGCTG GCTTAGGTTCACTAATCTATGTAACTGCAG GCTTAGGTTCATTAACCTATGTGACTGCAG GTCTAGGTTCTTTAATCTATTCAAGTGCTG	3	0.8392857142857143	ACGTTTGCATTAATTATGTGAAATCTCC CAAATTTTCTAAATTGTTCATTATTGCA TTCTAAACTCATAACTATTATAGTATGG	{7025} {7053} {7059}
6.627132422683973	23813	24033	220	23813	3	0.9464285714285714	AGCTGGCATTTGTGCTAGTTACCATACAGT TGCTGGCATATGTGCAAGTTACCATTCCAT TGCTGGCATTTGTGCTAGCTACCATACAGC	24003	4	0.9107142857142857	GCCGTGGATTGTACTATGTACATCTGCGGT TCAGTAGATTGTACAATGTACATCTGTGGT TCCGTAGACTGTACAATGTACATTTGCGGT TCTGTAGATTGTACTATGTACATCTGCGGT	3	0.8035714285714286	ACAAATTTTTCAATCAGTGTCACGACTG ATAATTCAATTGCCATACCTACTAATTT CTCACTTTTACGGAGTACAGGTCAAAAA	{23946} {23926} {23843}
6.642772931341441	6968	7196	228	6968	3	0.9464285714285714	CACTTCCTACGACTATTGCTAAAAATAGTG CTATGCCAACCACTATAGCAAAGAATACTG CTATGCCAACTACTATAGCTAAAAATACGG	7166	4	0.9107142857142857	CTCCTTCTTATTGTAGTGGCGTTAGAGAAT TCCCTTCTTATTGTGGTGGTGTTAGAGATT TGCCGTCATACTGTACAAGTTACAGAGATG TTCCTTCTTATTGTGATGGCGTTAGAGAGT	3	0.8392857142857143	ACGTTTGCATTAATTATGTGAAATCTCC CAAATTTTCTAAATTGTTCATTATTGCA TTCTAAACTCATAACTATTATAGTATGG	{7025} {7053} {7059}
6.751723285568202	8238	8416	178	8238	5	0.9285714285714286	AGAAGCTGAACTTGCAAAGAATGTGTCTTT TCATAGTGAGCTAGCGAAGGGTGTGGCTTT TCATAGTGAGCTGGCAAAGGGTGTAGCTTT TCATAGTGAGTTGGCTAAGGGTGTTGCTTT TGAGACTGAACTTGCTAAGAATGTGTCTTT	8386	2	0.9464285714285714	ACAGGTGACAGTTGTAACAACTTCATGCTC ACAGGTGACAGTTGTAATAACTATATGCTC	5	0.8392857142857143	ACATTTGTGTCCGCAGCCCGTCAAGGTG CTACATTTGTGTCGGCTGCTCGTCAAGG CTTTCAACATTTATCTCAGCAGCTCGTC GATGGTGTCTTATCCACATTTGTTTCAG GTGTCTCAAACTTTCTCACCATTCTGAT	{8284} {8282} {8278} {8269} {8349}
6.759771411322415	2984	3165	181	2984	3	0.9107142857142857	ATGGAGTGTGGCTACATTCTATTTGTTTGA GTGGAGTGTAGCTACATTCTACTTGTTTGA GTGGGGTGTTGCAACCTACTACTTGTTTGA	3135	4	0.9107142857142857	GAATACGGTACAGAAGAAGACTACCAAGGT GAATATGGCACAGAGGATGACTATAAAGGT GAGTATGGTACAGAGGATGATTATCAAGGT GAGTATGGTACTGAATCTGATTACAAAGGT	5	0.8392857142857143	AAAACTTTCTTCGCGCATGTACTGCTCT CCTCCTGATGAGGAAGAAGACTGTGAAG CGAGTCTGGTGAGTATACTTTGTCTTCA GAAGAAGAAATTGCTGATGAGACCTGTG GTGATGAGTATGAGGAAGAAGAGGAAGT	{3029} {3063} {3014} {3102} {3085}
6.831453964378334	7225	7392	167	7225	5	0.9107142857142857	ACAGCTTACTGTACGGGTTCTATACCGTGT ATGGACTTCTGTGAGGGCTCTTTTCCTTGT ATGGACTTTTGTCAGGGTTATTTTCCCTGC ATGGATTTCTGTGAAGGTTCTTTTCCTTGC GCAACCTACTGCACTGGTTCTATACCTTGT	7362	2	0.9821428571428571	AGCTGAGTGGTTTTTGGCATATATGTTGTT TGCAGAGTGGTGTTTGGCATATATTCTCTT	6	0.8392857142857143	AGTGTTTGTTTAAGTGGATTAGATTCGC AGTGTTTGTTTAGGTGGATTAGACTCTC CTAGATTCTCTTGATTCTTACCCCGCTT TATAAGCTAGACCTGACATTTTTGGGTT TGGTTTAGATTCTTTGGATACTTACCCA TGTCTTAGTGGTATGGATTCTTTAGATG	{7255} {7255} {7273} {7330} {7269} {7261}
6.895872960526725	8240	8485	245	8240	5	0.9107142857142857	AAGCTGAACTTGCAAAGAATGTGTCTTTAG AGACTGAACTTGCTAAGAATGTGTCTTTAG ATAGCGAGCTGGCAAAGGGTGTAGCTTTAG ATAGTGAGCTAGCAAAGGGTGTGGCTTTAG ATAGTGAGTTGGCTAAGGGTGTTGCTTTGG	8455	2	0.9642857142857143	GGTGCATGTATTGATTGTAATGCAAGGCAT GGTGCTTGTATTGATTGCAGTGCACGTCAT	5	0.8392857142857143	ATGGTGTCTTATCCACATTTATTTCAGC CCTTTCTACATTTGTGTCGGCTGCTCGT CTTTCAACATTTATCTCAGCAGCTCGTC GTGTCTCAAACTTTCTCACCATTCTGAT TTTGTGTCCGCAGCCCGTCAAGGTGTTG	{8270} {8277} {8278} {8349} {8287}
7.143164845367944	23873	24033	160	23873	4	0.9464285714285714	AATCATTGCTTACACTATGTCTTTAGGTGC AATTGTGGCCTATACTATGTCATTGGGTGC CATTGTGGCTTATACTATGTCTTTGGGTGC TATTGTGGCTTATACTATGTCACTTGGTGC	24003	4	0.9107142857142857	GCCGTGGATTGTACTATGTACATCTGCGGT TCAGTAGATTGTACAATGTACATCTGTGGT TCCGTAGACTGTACAATGTACATTTGCGGT TCTGTAGATTGTACTATGTACATCTGCGGT	3	0.8035714285714286	ACAAATTTTTCAATCAGTGTCACGACTG ATAATTCAATTGCCATACCTACTAATTT TGAAAATTCTGTGGCATATGCTAATAAT	{23946} {23926} {23903}
7.227270128054922	3577	3702	125	3577	5	0.9107142857142857	CCATGCAAAAAGAGAGCGATGATTACATTA CCATGCAACAGGAGAGTGATGATTACATTA CCATGCAGAAGGAGAGTGATGATTACATCA CTATGCAAATTGAGTCTGATGACTACATTG CTATGCAGAATGAGAGTGATGAATACATCA	3672	3	0.9107142857142857	TGCCTTCATGTTGTTGGTCCTAATCTCAAC TGTATGCATGTTGTTGGCCCAAACCTAAAT TGTCTGCATGTTGTTGGACCTAACCTAAAT	5	0.8392857142857143	ATGGTCCTCTCACAGTGGGAGGTTCATG CCACTCACAGTAGGTGGTTCATGTTTGC CCAGAAATGGACCACTAAACGTGGGTGG GGCAAAATGGACCTCTTACAGTTGGAGG TAGTTGGAGGTTCATGTTTGCTTTCTGG	{3613} {3618} {3607} {3607} {3625}
7.305633761645287	8208	8351	143	8208	5	0.9107142857142857	GGAAAAACTAAAAGCACTAGTTGCAACTGC GGAAAAACTTAAAGCACTAGTGGCCACTGC GGAAAAACTTAAGGCACTTGTTGCTACAGC GGAGAAACTTAAAGCATTAGTTGCAACTGC GGATAAGTTAAAAACTCTCATTGCAACAGC	8321	3	0.9107142857142857	CTGATGTTGACACAAAGGATGTCATTGAAT CTGATGTTGATACAAAGGACGTCATTGAGT CTGATGTTGATACTAAGGACGTTGTGGAAT	5	0.8214285714285714	ACATAGTGAGTTGGCAAAGGGTGTAGCT ACATTTGTGTCGGCTGCTCGTCAAGGTG GATGGTGTCTTATCCACATTTGTTTCAG GTCTTTAGATAATGTCCTTTCAACATTT TTTGTGTCCGCAGCCCGTCAAGGTGTTG	{8238} {8284} {8269} {8262} {8287}
7.381005354025413	7107	7272	165	7107	5	0.9107142857142857	CCTAGGTTCTTTAACCTATGTAACTGCTGT CTTAGGTTCACTAATCTATGTAACTGCAGC CTTAGGTTCTTTAACCTATGTGATTGCAGC CTTGGGTTCATTAATCTATGTGACTGCAGC TCTAGGTTCTTTAATCTATTCAAGTGCTGC	7242	3	0.9107142857142857	TTCTATACCGTGTAGTGTTTGTCTTAGTGG TTCTTTTCCCTGCAGTGTCTGTTTAAGTGG TTCTTTTCCTTGCAGTGTTTGTTTAAGTGG	5	0.7857142857142857	CTTGGTGTATGCCTATCTAGTTTAGGTG TTAGGTGTATTATTGTCCAACTTTGGAG TTAGGTGTATTATTTTCCAACTATGGAG TTGGTGTGCTTTTATCTAATTTAGGCAT TTTGATGTCTAATCTAGGTATGCCGTCA	{7138} {7138} {7138} {7139} {7146}
7.394754842851935	19997	20212	215	19997	5	0.9285714285714286	CACTGTCATCTGGGACTACAAAAGAGAAGC TACGGTGATTTGGGACTACAAAAGAGAAGC TACTGTAATCTGGGACCACAAGAGAGAAGC TACTGTGGTCTGGGACTACAAGAGAGAAGC TACTGTTATCTGGGACTACAAAAGAGAAGC	20182	3	0.9107142857142857	CAGAAGGTTCAGTCAAGGGTTTAACACCAT CAGAAGGTTCAGTTAAAGGTTTAACACCTT CTGAGGGTAATGTAAAAGGATTACAACCAT	4	0.8392857142857143	ACCAGTACATATGTCAACAATAGGTGTC AGCTTATGTTTCTACAATAGGTGTCTGT GGGACAGGTAGACTTTTTCAGAAATGCT TGGTAGAGTTGAAGGACAGGTTGACTTA	{20027} {20030} {20135} {20123}
7.4264714113224155	9328	9509	181	9328	5	0.9107142857142857	GACTCTGAGTACTGTAGACATGGTACTTGT GATGCAGAGTACTGCCGTCATGGCACATGT GATGCTGAGTACTGTAGACATGGTACATGC GATGCTGAGTATTGCAGACATGGTACTTGT GATTCAGAGTATTGTAGACATGGTACTTGC	9479	3	0.9107142857142857	TCTTTACACCTCTTGTTCAACCTGTGGGTG TCTTTACTCCCCTTGTGCAACCTGTGGGTG TGTTTACACCTTTGATTCAACCTATTGGTG	5	0.8035714285714286	ATAGAGCTCTACCTGGAGTATTTTGTGG GAAAGGTCAGAAGTTGGTGTGTGCTTAT GAGAGGTCAGAAGCTGGTATTTGCTTGT TGATTATTATAGATCATTACCTGGTGTG TTGCTTGTCTACTAGCGGTAGGTGGGTT	{9422} {9358} {9358} {9414} {9378}
7.535466666009797	3577	3807	230	3577	5	0.9107142857142857	CCATGCAAAAAGAGAGCGATGATTACATTA CCATGCAACAGGAGAGTGATGATTACATTA CCATGCAGAAGGAGAGTGATGATTACATCA CTATGCAAATTGAGTCTGATGACTACATTG CTATGCAGAATGAGAGTGATGAATACATCA	3777	3	0.9107142857142857	CTCTCAGCAGGCATCTTTGGTGCACAACCA TTATCAGCTGGTATTTTTGGTGCTGATCCT TTGTCAGCAGGCATATTTGGTGCTAAACCA	5	0.8035714285714286	AACGAAATGGACCACTCACAGTAGGTGG CCAGAAATGGACCACTAAACGTGGGTGG CTCACAGTGGGGGGTTCATGTTTGCTTT TAGTTGGAGGTTCATGTTTGCTTTCTGG TATGAGAATTTCAATTCACAGGATGTAT	{3607} {3607} {3621} {3625} {3735}
7.677119948987032	23592	23839	247	23592	5	0.9464285714285714	AGTGTAATAACACCTGGAACAAATGCTTCA AGTGTAATTACACCAGGAACAAATGCTTCT AGTGTCATAACACCAGGAACTAACACTTCA AGTGTGATAACACCAGGTACAAACACTTCT AGTGTTATCACACCTGGAACGAACGCCTCA	23809	3	0.9285714285714286	TCGGTGCTGGCATATGTGCAAGTTACCATT TTGGTGCAGGAATATGCGCCAGTTATCAGA TTGGTGCTGGCATTTGTGCTAGCTACCATA	6	0.8035714285714286	AACATGTTAACGCTTCGTATGAGTGTGA CTACTATACATGCAGACCAATTAACACC GATGTTAACTGTACTGAAGTGCCTATGG GCAGATCAATTAACACCTGCTTGGCGCG GCAGTGGCTGTTCTTTACCAAGATGTAA TGTCAATGCTTCATATGAGTGTGACATT	{23773} {23671} {23646} {23682} {23625} {23777}
7.686134243325825	23812	23906	94	23812	3	0.9285714285714286	GTGCAGGAATATGCGCCAGTTATCAGACTC GTGCTGGCATATGTGCAAGTTACCATTCCA GTGCTGGCATTTGTGCTAGCTACCATACAG	23876	5	0.9464285714285714	CATTGCTTACACTATGTCTTTAGGTGCAGA TGTGGCTTACACTATGTCTTTGGGTGCAGA TGTGGCTTATACTATGTCACTTGGTGCAGA TGTGGCTTATACTATGTCTTTAGGTGCTGA TGTTGCCTATACTATGTCACTGGGTGCTGA	11	0.8035714285714286	ACTTACGGAGTACAGGTCAAAAATCCAT ATATTACGCAGTACAAGCCAGAAAGCTA CATCATTTCGTAGTGTCAACCAGCGTTC CTCTACGTAGTATAGGTCAGAAATCCAT CTCTACGTGGTGTAGGTCAGAAATCCAT CTCTTACGTAATACAGACCAGAAATCAA CTTCAGTGTTACGCAGTACAGGCCAGAA CTTCTGTTCTACGTAGTACCGGCCAGAA CTTTACGTAGTGTAGGTCAGAAATCCAT GTTCTACGTAGTACAGGCCAAAAGTCAA TTTTACGGAGTACAGGTCAAAAATCTAT	{23848} {23847} {23845} {23848} {23848} {23847} {23842} {23842} {23848} {23847} {23848}
8.014785018119717	24003	24197	194	24003	4	0.9107142857142857	GCCGTGGATTGTACTATGTACATCTGCGGT TCAGTAGATTGTACAATGTACATCTGTGGT TCCGTAGACTGTACAATGTACATTTGCGGT TCTGTAGATTGTACTATGTACATCTGCGGT	24167	5	0.9464285714285714	CAAAACACCACCTATTAAAGATTTTGGTGG CAAAACCCCAACTTTGAAAGATTTTGGTGG CAAGACACCAGCCATAAAGGATTTTGGCGG TAAAACACCAACCATAAGAGATTTTGGTGG TAAGACACCAGCCATAAAAGATTTTGGTGG	4	0.8035714285714286	CACAAGAAGTTTTTGCCCAGGTTAAACA GACTCTATAGAGTGTAGCAACTTGTTGT GAGGTTTTTGCCCAAGTTAAACAAATGT GCATTGCTATAGAACAGGACAAAAACAC	{24133} {24033} {24138} {24106}
8.053073533078033	7225	7436	211	7225	5	0.9107142857142857	ACAGCTTACTGTACGGGTTCTATACCGTGT ATGGACTTCTGTGAGGGCTCTTTTCCTTGT ATGGACTTTTGTCAGGGTTATTTTCCCTGC ATGGATTTCTGTGAAGGTTCTTTTCCTTGC GCAACCTACTGCACTGGTTCTATACCTTGT	7406	4	0.9107142857142857	ACTTACTTGGTCTCTCCGCCATAATGCAAG ACTTACTTGGTCTCTCTGCTATAATGCAGG ATGTACTAGGTTTAGCCGCAATTATGCAAT ATTTACTAGGTCTTTCAGCTATAATGCAGG	4	0.7678571428571429	AGTGTTTGTTTAAGTGGATTAGATTCGC AGTGTTTGTTTAGGTGGATTAGACTCTC TATAAGCTAGACCTGACATTTTTGGGTT TGTCTTAGTGGTATGGATTCTTTAGATG	{7255} {7255} {7330} {7261}
8.109389758004454	3015	3165	150	3015	5	0.9285714285714286	GACGCTGGTGAAGAAAAACTTTCATCACGC GAGTCCGGTGAATTTAAATTGTCTTCACAT GAGTCTGGTGAGTATACTTTGTCTTCACGT GATGCTGGTGAAGAAAAACTTTCTTCACGT GATGCTGGTGAAGAAAACCTTTCATCGCGT	3135	4	0.9107142857142857	GAATACGGTACAGAAGAAGACTACCAAGGT GAATATGGCACAGAGGATGACTATAAAGGT GAGTATGGTACAGAGGATGATTATCAAGGT GAGTATGGTACTGAATCTGATTACAAAGGT	6	0.8214285714285714	AAGAAGAATACAGCGAAGAGGAACAACC CCTCCTGATGAGGAAGAAGACTGTGAAG GCAGGGTGTGAGGAGGAGGAAATCGCTG GTGATGAGTATGAGGAAGAAGAGGAAGT TCCTGATGAGGAAGAAGAATGTGAAGAG TGAAGAGTATGAGGATGAGGAAGAAATT	{3088} {3063} {3090} {3085} {3065} {3086}
8.121619948987032	19997	20244	247	19997	5	0.9285714285714286	CACTGTCATCTGGGACTACAAAAGAGAAGC TACGGTGATTTGGGACTACAAAAGAGAAGC TACTGTAATCTGGGACCACAAGAGAGAAGC TACTGTGGTCTGGGACTACAAGAGAGAAGC TACTGTTATCTGGGACTACAAAAGAGAAGC	20214	4	0.9107142857142857	AAAGGACCTGCACAGGCTAGTGTCAACGGA AAAGGACCTGTGCAAGCAAGTGTCAATGGA AAGGGACCAGCACAAGCTAGTGTCAATGGA GTAGGTCCAAAACAAGCTAGTCTTAATGGA	4	0.875	ACCAGTACATATGTCAACAATAGGTGTC AGCTTATGTTTCTACAATAGGTGTCTGT AGGTTCAGTTAAGGGCTTAACACCTTCG TGGTAGAGTTGAAGGACAGGTTGACTTA	{20027} {20030} {20186} {20123}
8.188687395870145	9328	9551	223	9328	5	0.9107142857142857	GACTCTGAGTACTGTAGACATGGTACTTGT GATGCAGAGTACTGCCGTCATGGCACATGT GATGCTGAGTACTGTAGACATGGTACATGC GATGCTGAGTATTGCAGACATGGTACTTGT GATTCAGAGTATTGTAGACATGGTACTTGC	9521	4	0.9107142857142857	CAGCTTCAATTGTTGCAGGTGGTTTAGTTG CAGCTTCTGTAGTAGCGGGTGGTATCATTG CTGCTTCAGTAGTAGCAGGTGGTATCATTG CTGCTTCAGTAGTGGCTGGTGGTATTATTG	5	0.8035714285714286	ATAGAGCTCTACCTGGAGTATTTTGTGG GAAAGGTCAGAAGTTGGTGTGTGCTTAT GAGAGGTCAGAAGCTGGTATTTGCTTGT TGATTATTATAGATCATTACCTGGTGTG TTGCTTGTCTACTAGCGGTAGGTGGGTT	{9422} {9358} {9358} {9414} {9378}
