cost	target-start	target-end	target-length	left-primer-start	left-primer-num-primers	left-primer-frac-bound	left-primer-target-sequences	right-primer-start	right-primer-num-primers	right-primer-frac-bound	right-primer-target-sequences	num-guides	total-frac-bound-by-guides	guide-target-sequences	guide-target-sequence-positions
4.4531010878282045	539	692	153	539	2	1.0	GTTGATAGTAATCGTAAGGATCACTACGTC GTTGATTGCGATCGTAAGGATCACTACGTC	662	2	1.0	TGCAATGGCGTTCTCGAGGACTTTGACTTT TGCAATGGCGTTCTTGAGGACTTTGACCTT	3	0.9922480620155039	GAGTAAGCGATCTTAAACCTGTTCTTCT TGGTGTTCTGGGTAACGGAATAAGTGAT TGGTGTTCTGGGTAACGGGATAAGTGAT	{588} {571} {571}
4.650216028494806	20155	20387	232	20155	2	0.9922480620155039	TGGACTCACACCTCCATTAACAATACTTAG TGGACTCACACCTCCGTTAACAATACTTAG	20357	2	0.9922480620155039	GACGCAGTGCTTATTTCTAATAACGCTGTG GATGCAGTGCTTATTTCTAATAACGCTGTG	3	1.0	ATAGTGAAGTTGTAACATGTTTTGATAA CTTTCTCAAATTTCACTAAGCAAGTGTG CTTTCTCAAATTTCACTACGCAAGTGTG	{20289} {20244} {20244}
4.7349942636812	36957	37045	88	36957	4	0.9922480620155039	GACAACCCGATGTTTAAAACTGGTCTTTCC GGCAACCCGATGTCTAAAACTGGTCTTTCC GGCAACCCGATGTTTAAAACTAGTCCTTCC GGCAACCCGATGTTTAAAACTGGTTTTTCC	37015	1	0.9922480620155039	CTCTTGTACAGAATGGTAAGCACGTGTAAT	3	1.0	GAGGAACTACTAGTCATCGCGCTGTCTA GAGGAATTACGGGTCATCGCGCTGCCTA GAGGAATTACTGGTCATCGCGCTGTCTA	{36987} {36987} {36987}
5.148857335320482	20357	20489	132	20357	2	0.9922480620155039	GACGCAGTGCTTATTTCTAATAACGCTGTG GATGCAGTGCTTATTTCTAATAACGCTGTG	20459	3	0.9922480620155039	CCTATCACATGGTACATCTATGTGCGCAAG CCTGTCACATGGTATATCTATGTGCGCAAG CTTGTCACATGGTATATATATGTGCGCAAG	4	0.9844961240310077	AATGATTTACCTGTAAGTACTGTAGGAA ATTAAGTTACAATACGGCCTTTTGAATG TTAAATTACAATATGGCTTCTTGAATGA TTAAATTACAATATGGCTTTTTGAATGA	{20426} {20402} {20403} {20403}
5.281479969342407	34252	34466	214	34252	2	0.9922480620155039	CAGCTGGTTCGTGTATGGCATTAAAATGCT TAGCTGGCTCGTTTATGGCATTAAAATGCT	34436	3	0.9922480620155039	CAGCTATACAGAAGGACTAAGTCCTGGTGG CAGCTATATAGAAGGACCAAATCATGGTGG CAGTTGTACAGAAGGACTAAGTCTTGGTGG	3	0.9922480620155039	CTTTAGTGTTGCAGGTGCAATTGTTACA GAGTACCAAGTTTCCAGATATGTAATGT TTTTAATGCATACTCGGAATATGAAGTG	{34372} {34340} {34324}
5.646011090344213	539	629	90	539	2	1.0	GTTGATAGTAATCGTAAGGATCACTACGTC GTTGATTGCGATCGTAAGGATCACTACGTC	599	4	0.9922480620155039	CTTAAACCCGTTCTTCTTACCGAACCTTCC CTTAAACCTGTTCTCCTTACCGAACCTTCC CTTAAACCTGTTCTTCTCACCGAACCTTCC CTTAAACCTGTTCTTCTTACCGAACCCTCC	5	0.9922480620155039	CGGTGTTCTTGGTAACGGAGTAAGCGAT TGGTGTTCTCGGCAACGGAATAAGTGAT TGGTGTTCTCGGTAACGGAGTAAGCGAT TGGTGTTCTGGGTAACGGAATAAGTGAT TGGTGTTCTGGGTAACGGGATAAGTGAT	{571} {571} {571} {571} {571}
5.828643513028184	415	625	210	415	3	0.9922480620155039	CAACGAGGACTATCAAGTCAACGTGCCTAG TAATGAGGACTACCAAATCAACGTGTCTAG TAATGAGGACTACCAAGTCAACGTGCCTAG	595	3	0.9922480620155039	TGATCTTAAACCTGTGCTTCTCACCGAACC TGATCTTAAACCTGTTCTCCTTACCGAACC TGATCTTAAACCTGTTCTTCTTACCGAACC	2	0.9922480620155039	CCTAGTTGATTGCGATCGTAAGGATCAC TTCCGTGAGGCTTTGCAGGAAATTAAGT	{535} {452}
5.849332422683972	20357	20577	220	20357	2	0.9922480620155039	GACGCAGTGCTTATTTCTAATAACGCTGTG GATGCAGTGCTTATTTCTAATAACGCTGTG	20547	4	0.9922480620155039	CCTTTAAACCTCGTAGTACAATGGAAGAAG CCTTTAAGCCTCGCAGTACAATGGAAGAAG CCTTTAAGCCTCGTAGTACAATGGAGGAAG CTTTTAAACCTCGTAGTACAATGGAGGAAG	2	0.9922480620155039	GTTATTATACACAGGGACGTACTTTTGA TTAAATTACAATATGGCTTTTTGAATGA	{20517} {20403}
5.898764373321448	20195	20387	192	20195	4	0.9922480620155039	GTTGTCGCAACACATAAATTTGTGTTGTGG GTTGTCGCAACATACAAATTTGTGTTGTGG GTTGTCGCAACATATAAATTCGTGTTGTGG GTTGTCGCAACATATAAGTTTGTGTTGTGG	20357	2	0.9922480620155039	GACGCAGTGCTTATTTCTAATAACGCTGTG GATGCAGTGCTTATTTCTAATAACGCTGTG	3	1.0	ATAGTGAAGTTGTAACATGTTTTGATAA CTTTCTCAAATTTCACTAAGCAAGTGTG CTTTCTCAAATTTCACTACGCAAGTGTG	{20289} {20244} {20244}
6.052973533078032	550	761	211	550	1	0.9922480620155039	TCGTAAGGATCACTACGTCATTGGTGTTCT	731	5	0.9922480620155039	CAACATATGTGTGGTGCTGATGGAAAACCA CAATACATGTGTGGCGCTGATGGGAAGCCA CAATACATGTGTGGGGCTGATGGTAAACCA CAATACATGTGTGGTGCTGATGGAAAACCA CAATACATGTGTGGTGCTGATGGAAAGCCA	4	1.0	GAGGACTTTGACCTTAAAATTGCCCGAA GGTAACGGAGTAAGCGATCTTAAACCTG GTAACGGAGTAAGTGATCTTAAGCCTGT TCATTGTTAGAGCCAACTGCAATGGCGT	{677} {581} {582} {645}
6.396716373031191	34252	34390	138	34252	2	0.9922480620155039	CAGCTGGTTCGTGTATGGCATTAAAATGCT TAGCTGGCTCGTTTATGGCATTAAAATGCT	34360	4	0.9922480620155039	TGTAATGTTCAGCTTTAGTATTGCAGGTGC TGTAATGTTCGGCTTTAGTATCGCAGGTGC TGTAATGTTCGGCTTTAGTGTTGCAGGTGC TGTAATGTTCGGTTTTAGTATTGCAGGTGC	9	1.0	ATGCATACTCTGAGTATAATGTTTCCAG ATTGTTTTGGCTCTTACGATTTTTAAAG TCTTACGATTTTTAATGCATACGCGGAG TGCATACTCGGAATATGAAGTTTCCAGA TGCATACTCTGAGTACGAAGTTTCCAGA TGCATATTCGGAGTACCAAGTTTCCAGA TTTTAATGCATACTCGGAATACCAAGTG TTTTAATGCATACTCTGAGTACCAAGTT TTTTTAATGCATACTCTGAGTATCAAGT	{34329} {34304} {34315} {34330} {34330} {34330} {34324} {34324} {34323}
6.476364845367944	419	579	160	419	5	0.9922480620155039	GAGGACTACCAAATCAACGTGTCTAGCTTC GAGGACTACCAAGTCAACGTGCCTAGCCAC GAGGACTACCAAGTCAACGTGCCTAGCCTT GAGGACTATCAAGTCAACGTGCCTAGCCTC GAGGACTATCAAGTCAACGTGCCTAGTCTT	549	1	0.9922480620155039	ATCGTAAGGATCACTACGTCATTGGTGTTC	9	0.9922480620155039	AGGAAATTAAGTACTGCTACCGTAACGG AGGAAATTAAGTACTGCTATCGTAACGG AGGACTGCTACCGCAACGGTTTTGATGG CCGTGACGTATTGCAGGACATTAAGTGC CTGCAGGAAATCAAGTACTGCTACCGTA TACCAGAATACTGTCGTGACCTAGTTGA TGCCTGAATACCGTCGTGACCTAGTTGA TTCCGTGACGTGCTGCAGGACATTAAGT TTCGTGCCTGAATACCGCCGTGACCTAG	{468} {468} {477} {454} {464} {516} {516} {452} {512}
6.531672931341441	35527	35629	102	35527	2	0.9922480620155039	AAACAAACACACCTGGAAGAGAACTGCAGG CAACAAACACACCTGGAAGAAAACTGCAGG	35599	5	0.9922480620155039	AGCCAATTTTGGTGACAGCGATCTCGTTGC AGCCAATTTTGGTGACAGTGACCTCGTTGC AGCTAACTTTGGTGATAGTGACCTCGTTGC AGCTAACTTTGGTGATAGTGATCTCGTTGC GGCCAACTTTGGTGATAGTGATCTCGTTGC	6	0.9844961240310077	AAGGGAGATGTGACAACTTTCTATGGTG CAAGATTCTATGGAACTCGAAGCAGTTC GACAAATTTCTATGGTGCTAGAAGTGCT GAGATGTGACAAATTTCTACGGTGCTAG GTGATGTGACAAATTTCTATGGTGCTAG TGACAAGATTTTATGGAGCTAGAAGCAG	{35558} {35571} {35569} {35562} {35562} {35568}
6.646111090344212	505	595	90	505	4	0.9922480620155039	CTATGTCTTCGTGCCAGAATACTGTCGTGA CTATGTTTTCGTACCAGAATACTGTCGTGA CTATGTTTTCGTGCCTGAATACCGTCGTGA TTATGTTTTCGTGCCTGAATACCGCCGTGA	565	4	0.9922480620155039	CGTCATTGGTGTTCTCGGCAACGGAATAAG CGTCATTGGTGTTCTGGGTAACGGAATAAG CGTCATTGGTGTTCTTGGTAACGGAGTAAG CGTCATTGGTGTTTTAGGCAACGGAATAAG	2	1.0	CCTAGTTGATTGCGATCGTAAGGATCAC CCTAGTTGATTGTAATCGTAAGGATCAC	{535} {535}
6.719673533078033	18965	19176	211	18965	2	0.9922480620155039	TGGGCTGGTGGTCTGGAACTTACAACTATG TGGGCTGGTGGTCTTGAGCTTACAACTATG	19146	5	0.9922480620155039	GGGGCTACACAGGATCTTTGAGCATGAATC GGGGCTACACAGGTTCTCTGAGCATGAATC GGGGCTACACAGGTTCTTTGAGCATGAATC GGGGCTATACAGGTTCCCTAAGCATGAACC GGGGTTATACAGGATCCTTGAGCATGAACC	4	0.9922480620155039	ACAAAAATGTGATTGCGGCAAAACGGCA CAACTTGTTATAGTAGCTCTCAATCTGT CACAAAAATGTGAGTGCGGCAAAATGGC GAAACCACAAAAATGTGAATGCGGCAAA	{19021} {19047} {19020} {19015}
7.291722592664184	34171	34390	219	34171	3	0.9922480620155039	CGCTAACTGGAACTTCAGCTGGTCTATAAT TGCAAACTGGAACTTCAGCTGGTCTATAAT TGCTAACTGGAACTTCAGCTGGTCTGTAAT	34360	4	0.9922480620155039	TGTAATGTTCAGCTTTAGTATTGCAGGTGC TGTAATGTTCGGCTTTAGTATCGCAGGTGC TGTAATGTTCGGCTTTAGTGTTGCAGGTGC TGTAATGTTCGGTTTTAGTATTGCAGGTGC	9	1.0	ATGCATACTCGGAGTATCAAGTTTCCAG ATGCATACTCTGAGTATAATGTTTCCAG ATGCATATTCGGAGTACCAAGTTTCCAG ATTGTTTTGGCTCTTACGATTTTTAAAG TGCATACTCGGAGTACGAAGTTTCCAGA TTTTAATGCATACTCGGAATACCAAGTG TTTTAATGCATACTCGGAATATGAAGTG TTTTAATGCATACTCTGAGTACCAAGTT TTTTTAATGCATACTCTGAGTATCAAGT	{34329} {34329} {34329} {34304} {34330} {34324} {34324} {34324} {34323}
7.315046828807647	19954	20185	231	19954	5	0.9922480620155039	CAAAGCACTCCAGAGTCTAGAAAATGTGGC CAAAGCACTCCAGAGTTTAGAAAATGTAGC CAAAGCACTCCAGAGTTTGGAAAATGTAGC CAAAGCACTTCAGAGTCTAGAAAATGTGGC CAGAGCACTTCAGAGTTTAGAAAATGTGGC	20155	2	0.9922480620155039	TGGACTCACACCTCCATTAACAATACTTAG TGGACTCACACCTCCGTTAACAATACTTAG	9	1.0	AAAGGTGCTTTTGCTGATTTAAAGGGCG AGGGACGGACCTACTGACAAGTGCATTT AGGGATGGACCGACTGACAAGTGTATTT AGGGATGGACCTACTGACAAGTGTATTT GATCATGGTGAGGAACGGACCTACTGAC GCTGATAGGGTTATGGTGAGGGATGGCT GTCTAAAAGGAGACTTACCAACTGCTGT TGCTGACAAAATAATGGTAAGAGATGGA TTATGGTAAGAGATGGACCTACTGACAA	{20000} {20066} {20066} {20066} {20056} {20048} {20016} {20047} {20058}
7.606243925003943	595	761	166	595	3	0.9922480620155039	TGATCTTAAACCTGTGCTTCTCACCGAACC TGATCTTAAACCTGTTCTCCTTACCGAACC TGATCTTAAACCTGTTCTTCTTACCGAACC	731	5	0.9922480620155039	CAACATATGTGTGGTGCTGATGGAAAACCA CAATACATGTGTGGCGCTGATGGGAAGCCA CAATACATGTGTGGGGCTGATGGTAAACCA CAATACATGTGTGGTGCTGATGGAAAACCA CAATACATGTGTGGTGCTGATGGAAAGCCA	7	0.9844961240310077	ATTGTTAGAGCTAACTGCAATGGCGTGC CCGTCATGCTGCAAGGCTTCATCGTTAG CCGTCATGTTGCAAGGCTTCATTGTTAG CCGTCATGTTGCAAGGTTTTATTGTTAG GAGGACTTTGACCTTAAAATTGCCCGAA GCAAGGCTTTATTGTTAAGGCTAACTGC TCATTGTTAGAGCCAACTGCAATGGCGT	{647} {627} {627} {627} {677} {637} {645}
8.116170128054922	19328	19518	190	19328	5	0.9922480620155039	GCCGGTCGCATTGTCCAATCGCATGTCATG GCTGGTCGCATAGTGCAGTCACATGTCATG GCTGGTCGCATTGTACAATCACATATTATG GCTGGTCGCATTGTACAATCACATGTCATG GCTGGTCGCATTGTGCAATCGCATGTCATG	19488	4	1.0	GCCTGGACTATGACTATATGGTACATGGTC GTCTGGAGTATGATTACATGGTACATGGAC GTCTGGATTATGACTATATGGTACATGGTC GTTTGGACTATGACTATATGGTACATGGTC	5	1.0	CTGAAAATTTTTAACCCTGCTGCAATTC GAACTGCTCTTAAGGTTTTCAACCCTGC GAGCTGCTCTTAAGGTGTTTAGCCCTGC TCGTTGTGCTACGACACCCATACCGTGG TCTGAAGATTTTTAATCCTGCTGCAATT	{19367} {19359} {19359} {19420} {19366}
8.225788504066713	19328	19571	243	19328	5	0.9922480620155039	GCCGGTCGCATTGTCCAATCGCATGTCATG GCTGGTCGCATAGTGCAGTCACATGTCATG GCTGGTCGCATTGTACAATCACATATTATG GCTGGTCGCATTGTACAATCACATGTCATG GCTGGTCGCATTGTGCAATCGCATGTCATG	19541	4	0.9922480620155039	TGGAACTGTAATGTAGACATGTACCCAGAG TGGAATTGCAACGTAGACATGTACCCGGAG TGGAATTGCAATGTAGACATGTACCCAGAG TGGAATTGTAACGTAGACATGTACCCAGAG	5	1.0	CTGAAAATTTTTAACCCTGCTGCAATTC GAACTGCTCTTAAGGTTTTCAACCCTGC GAGCTGCTCTTAAGGTGTTTAGCCCTGC TCGTTGTGCTACGACACCCATACCGTGG TCTGAAGATTTTTAATCCTGCTGCAATT	{19367} {19359} {19359} {19420} {19366}
