cost	target-start	target-end	target-length	left-primer-start	left-primer-num-primers	left-primer-frac-bound	left-primer-target-sequences	right-primer-start	right-primer-num-primers	right-primer-frac-bound	right-primer-target-sequences	num-guides	total-frac-bound-by-guides	guide-target-sequences	guide-target-sequence-positions
4.564201087828204	539	692	153	539	2	1.0	GTTGATAGTAATCGTAAGGATCACTACGTC GTTGATTGCGATCGTAAGGATCACTACGTC	662	2	1.0	TGCAATGGCGTTCTCGAGGACTTTGACTTT TGCAATGGCGTTCTTGAGGACTTTGACCTT	4	0.9922480620155039	GTAACGGAGTAAGCGATCTTAAACCTGT TGGTGTTCTCGGCAACGGAATAAGTGAT TGGTGTTCTGGGTAACGGAATAAGTGAC TGGTGTTTTGGGTAACGGAATAAGTGAT	{582} {571} {571} {571}
4.650216028494806	20155	20387	232	20155	2	0.9922480620155039	TGGACTCACACCTCCATTAACAATACTTAG TGGACTCACACCTCCGTTAACAATACTTAG	20357	2	0.9922480620155039	GACGCAGTGCTTATTTCTAATAACGCTGTG GATGCAGTGCTTATTTCTAATAACGCTGTG	3	0.9922480620155039	ATAGTGAAGTTGTAACATGTTTTGATAA TCCTTTCTCAAACTTTACTAAGCAAGTG TTCTCAAATTTCACTAAGCAAGTGTGTT	{20289} {20242} {20246}
4.7349942636812	36957	37045	88	36957	4	0.9922480620155039	GACAACCCGATGTTTAAAACTGGTCTTTCC GGCAACCCGATGTCTAAAACTGGTCTTTCC GGCAACCCGATGTTTAAAACTAGTCCTTCC GGCAACCCGATGTTTAAAACTGGTTTTTCC	37015	1	0.9922480620155039	CTCTTGTACAGAATGGTAAGCACGTGTAAT	3	1.0	GAGGAACTACTAGTCATCGCGCTGTCTA GAGGAATTACGGGTCATCGCGCTGCCTA GAGGAATTACTGGTCATCGCGCTGTCTA	{36987} {36987} {36987}
5.148857335320482	20357	20489	132	20357	2	0.9922480620155039	GACGCAGTGCTTATTTCTAATAACGCTGTG GATGCAGTGCTTATTTCTAATAACGCTGTG	20459	3	0.9922480620155039	CCTATCACATGGTACATCTATGTGCGCAAG CCTGTCACATGGTATATCTATGTGCGCAAG CTTGTCACATGGTATATATATGTGCGCAAG	4	0.9844961240310077	AATGATTTACCTGTAAGTACTGTAGGAA ATTAAGTTACAATACGGCCTTTTGAATG TTAAATTACAATATGGCTTCTTGAATGA TTAAATTACAATATGGCTTTTTGAATGA	{20426} {20402} {20403} {20403}
5.392579969342407	34252	34466	214	34252	2	0.9922480620155039	CAGCTGGTTCGTGTATGGCATTAAAATGCT TAGCTGGCTCGTTTATGGCATTAAAATGCT	34436	3	0.9922480620155039	CAGCTATACAGAAGGACTAAGTCCTGGTGG CAGCTATATAGAAGGACCAAATCATGGTGG CAGTTGTACAGAAGGACTAAGTCTTGGTGG	4	1.0	CTTTAGTGTTGCAGGTGCAGTTGTAACG TGCATACTCGGAATACCAAGTTTCCAGA TTTAGTATTGCAGGTGCAATTGTTACAT TTTTTAATGCATACTCTGAGTATCAAGT	{34372} {34330} {34373} {34323}
5.646011090344213	539	629	90	539	2	1.0	GTTGATAGTAATCGTAAGGATCACTACGTC GTTGATTGCGATCGTAAGGATCACTACGTC	599	4	0.9922480620155039	CTTAAACCCGTTCTTCTTACCGAACCTTCC CTTAAACCTGTTCTCCTTACCGAACCTTCC CTTAAACCTGTTCTTCTCACCGAACCTTCC CTTAAACCTGTTCTTCTTACCGAACCCTCC	5	0.9922480620155039	TGGTGTTCTCGGCAACGGAATAAGTGAT TGGTGTTCTCGGTAACGGAGTAAGCGAT TGGTGTTCTGGGTAACGGAATAAGTGAT TGGTGTTCTGGGTAACGGGATAAGTGAT TGGTGTTCTTGGTAACGGAGTAAGTGAT	{571} {571} {571} {571} {571}
5.828643513028184	415	625	210	415	3	0.9922480620155039	CAACGAGGACTATCAAGTCAACGTGCCTAG TAATGAGGACTACCAAATCAACGTGTCTAG TAATGAGGACTACCAAGTCAACGTGCCTAG	595	3	0.9922480620155039	TGATCTTAAACCTGTGCTTCTCACCGAACC TGATCTTAAACCTGTTCTCCTTACCGAACC TGATCTTAAACCTGTTCTTCTTACCGAACC	2	0.9922480620155039	CCTAGTTGATTGCGATCGTAAGGATCAC TTCCGTGAGGCTTTGCAGGAAATTAAGT	{535} {452}
5.849332422683972	20357	20577	220	20357	2	0.9922480620155039	GACGCAGTGCTTATTTCTAATAACGCTGTG GATGCAGTGCTTATTTCTAATAACGCTGTG	20547	4	0.9922480620155039	CCTTTAAACCTCGTAGTACAATGGAAGAAG CCTTTAAGCCTCGCAGTACAATGGAAGAAG CCTTTAAGCCTCGTAGTACAATGGAGGAAG CTTTTAAACCTCGTAGTACAATGGAGGAAG	2	0.9922480620155039	GTTATTATACACAGGGACGTACTTTTGA TTAAATTACAATATGGCTTTTTGAATGA	{20517} {20403}
5.898764373321448	20195	20387	192	20195	4	0.9922480620155039	GTTGTCGCAACACATAAATTTGTGTTGTGG GTTGTCGCAACATACAAATTTGTGTTGTGG GTTGTCGCAACATATAAATTCGTGTTGTGG GTTGTCGCAACATATAAGTTTGTGTTGTGG	20357	2	0.9922480620155039	GACGCAGTGCTTATTTCTAATAACGCTGTG GATGCAGTGCTTATTTCTAATAACGCTGTG	3	0.9922480620155039	ATAGTGAAGTTGTAACATGTTTTGATAA TCCTTTCTCAAACTTTACTAAGCAAGTG TTCTCAAATTTCACTAAGCAAGTGTGTT	{20289} {20242} {20246}
5.941873533078033	550	761	211	550	1	0.9922480620155039	TCGTAAGGATCACTACGTCATTGGTGTTCT	731	5	0.9922480620155039	CAACATATGTGTGGTGCTGATGGAAAACCA CAATACATGTGTGGCGCTGATGGGAAGCCA CAATACATGTGTGGGGCTGATGGTAAACCA CAATACATGTGTGGTGCTGATGGAAAACCA CAATACATGTGTGGTGCTGATGGAAAGCCA	3	1.0	CCGTCATGCTGCAAGGCTTTATTGTTAG GTAACGGAGTAAGCGATCTTAAACCTGT TCATTGTTAGAGCCAACTGCAATGGCGT	{627} {582} {645}
6.174516373031191	34252	34390	138	34252	2	0.9922480620155039	CAGCTGGTTCGTGTATGGCATTAAAATGCT TAGCTGGCTCGTTTATGGCATTAAAATGCT	34360	4	0.9922480620155039	TGTAATGTTCAGCTTTAGTATTGCAGGTGC TGTAATGTTCGGCTTTAGTATCGCAGGTGC TGTAATGTTCGGCTTTAGTGTTGCAGGTGC TGTAATGTTCGGTTTTAGTATTGCAGGTGC	7	0.9922480620155039	ATTGTTTTGGCTCTTACGATTTTTAAAG TCTTACGATTTTTAATGCATACGCGGAG TGCATACTCGGAATACCAAGTTTCCAGA TGCATACTCGGAATATGAAGTCTCCAGA TGCGTACTCTGAGTACGAAGTTTCCAGA TTTAATGCATACTCTGAGTATAATGTTT TTTTTAATGCATACTCTGAGTATCAAGT	{34304} {34315} {34330} {34330} {34330} {34325} {34323}
6.4008000822449524	34172	34390	218	34172	2	1.0	GCAAACTGGAACTTCAGCTGGTCTATAATA GCTAACTGGAACTTCAGCTGGTCTGTAATA	34360	4	0.9922480620155039	TGTAATGTTCAGCTTTAGTATTGCAGGTGC TGTAATGTTCGGCTTTAGTATCGCAGGTGC TGTAATGTTCGGCTTTAGTGTTGCAGGTGC TGTAATGTTCGGTTTTAGTATTGCAGGTGC	7	0.9922480620155039	ATTGTTTTGGCTCTTACGATTTTTAAAG TCTTACGATTTTTAATGCATACGCGGAG TGCATACTCGGAATACCAAGTTTCCAGA TGCATACTCGGAATATGAAGTCTCCAGA TGCGTACTCTGAGTACGAAGTTTCCAGA TTTAATGCATACTCTGAGTATAATGTTT TTTTTAATGCATACTCTGAGTATCAAGT	{34304} {34315} {34330} {34330} {34330} {34325} {34323}
6.476364845367944	419	579	160	419	5	0.9922480620155039	GAGGACTACCAAATCAACGTGTCTAGCTTC GAGGACTACCAAGTCAACGTGCCTAGCCAC GAGGACTACCAAGTCAACGTGCCTAGCCTT GAGGACTATCAAGTCAACGTGCCTAGCCTC GAGGACTATCAAGTCAACGTGCCTAGTCTT	549	1	0.9922480620155039	ATCGTAAGGATCACTACGTCATTGGTGTTC	9	0.9922480620155039	AGGAAATTAAGTACTGCTACCGTAACGG AGGAAATTAAGTACTGCTATCGTAACGG AGGACTGCTACCGCAACGGTTTTGATGG CCGTGACGTATTGCAGGACATTAAGTGC CTGCAGGAAATCAAGTACTGCTACCGCA TACCAGAATACTGTCGTGACCTAGTTGA TGCCTGAATACCGTCGTGACCTAGTTGA TTCCGTGACATGCTGCAGGACATTAAGT TTCGTGCCTGAATACCGCCGTGACCTAG	{468} {468} {477} {454} {464} {516} {516} {452} {512}
6.531672931341441	35527	35629	102	35527	2	0.9922480620155039	AAACAAACACACCTGGAAGAGAACTGCAGG CAACAAACACACCTGGAAGAAAACTGCAGG	35599	5	0.9922480620155039	AGCCAATTTTGGTGACAGCGATCTCGTTGC AGCCAATTTTGGTGACAGTGACCTCGTTGC AGCTAACTTTGGTGATAGTGACCTCGTTGC AGCTAACTTTGGTGATAGTGATCTCGTTGC GGCCAACTTTGGTGATAGTGATCTCGTTGC	6	0.9844961240310077	AAGGGAGATGTGACAACTTTCTATGGTG CAAGATTCTATGGAACTCGAAGCAGTTC GACAAATTTCTATGGTGCTAGAAGTGCT GAGATGTGACAAATTTCTACGGTGCTAG GTGATGTGACAAATTTCTATGGTGCTAG TGACAAGATTTTATGGAGCTAGAAGCAG	{35558} {35571} {35569} {35562} {35562} {35568}
6.646111090344212	505	595	90	505	4	0.9922480620155039	CTATGTCTTCGTGCCAGAATACTGTCGTGA CTATGTTTTCGTACCAGAATACTGTCGTGA CTATGTTTTCGTGCCTGAATACCGTCGTGA TTATGTTTTCGTGCCTGAATACCGCCGTGA	565	4	0.9922480620155039	CGTCATTGGTGTTCTCGGCAACGGAATAAG CGTCATTGGTGTTCTGGGTAACGGAATAAG CGTCATTGGTGTTCTTGGTAACGGAGTAAG CGTCATTGGTGTTTTAGGCAACGGAATAAG	2	1.0	CCTAGTTGATTGCGATCGTAAGGATCAC CCTAGTTGATTGTAATCGTAAGGATCAC	{535} {535}
6.719673533078033	18965	19176	211	18965	2	0.9922480620155039	TGGGCTGGTGGTCTGGAACTTACAACTATG TGGGCTGGTGGTCTTGAGCTTACAACTATG	19146	5	0.9922480620155039	GGGGCTACACAGGATCTTTGAGCATGAATC GGGGCTACACAGGTTCTCTGAGCATGAATC GGGGCTACACAGGTTCTTTGAGCATGAATC GGGGCTATACAGGTTCCCTAAGCATGAACC GGGGTTATACAGGATCCTTGAGCATGAACC	4	0.9844961240310077	AATGCGGCAAAAGTGCAACTTGTTATAG ACAAAAATGTGATTGCGGCAAAACGGCA CACAAAAATGTGAGTGCGGCAAAATGGC GCAACTTGTTATAGTAGCTCTCAATCTG	{19032} {19021} {19020} {19046}
6.8761220447775875	21035	21269	234	21035	1	1.0	CGTATGTGTCTCGAACGGTGTAATCTCTAC	21239	5	0.9922480620155039	AGATGGTTACCAGATGATGCCATATTGGTT AGATGGTTGCCAGACGATGCCATATTGGTT AGATGGTTGCCAGATGACGCCATATTGGTT AGGTGGCTACCAGATGATGCCATATTGGTT AGGTGGTTACCAGACGATGCCATATTGGTT	11	1.0	AATTATGGTGCACAAGTGAGGTTACCTG CACTTAGGGGCAGCAGGTGCTAATGGTG CATTTAGGAGCTGCAGGTGCAGCTGGTG CGTGTATTGCATTTAGGAGCTGCTGGTG GTCTTGCATTTAGGAGCTGCTGGTGCAT GTGTTTTGCATTTAGGAGCAGCAGGCGC GTGTTTTGCATTTAGGTGCAGCAGGCGC GTGTTTTGCATTTGGGAGCAGCAGGTGC TACTGCACCTAGGAGCAGCAGGTGCAAA TGCATTTAGGAGCAGCAGGTGCTAATGG TTAGGAGCAGCAGGGGCTAATGGTGTTG	{21065} {21185} {21185} {21176} {21179} {21177} {21177} {21177} {21180} {21183} {21188}
7.606243925003943	595	761	166	595	3	0.9922480620155039	TGATCTTAAACCTGTGCTTCTCACCGAACC TGATCTTAAACCTGTTCTCCTTACCGAACC TGATCTTAAACCTGTTCTTCTTACCGAACC	731	5	0.9922480620155039	CAACATATGTGTGGTGCTGATGGAAAACCA CAATACATGTGTGGCGCTGATGGGAAGCCA CAATACATGTGTGGGGCTGATGGTAAACCA CAATACATGTGTGGTGCTGATGGAAAACCA CAATACATGTGTGGTGCTGATGGAAAGCCA	7	0.9844961240310077	ATTGTTAGAGCTAACTGCAATGGCGTGC CCGTCATGCTGCAAGGCTTCATCGTTAG CCGTCATGTTGCAAGGCTTCATTGTTAG CCGTCATGTTGCAAGGTTTTATTGTTAG GAGGACTTTGACCTTAAAATTGCCCGAA GCAAGGCTTTATTGTTAAGGCTAACTGC TCATTGTTAGAGCCAACTGCAATGGCGT	{647} {627} {627} {627} {677} {637} {645}
8.560935466635868	20221	20465	244	20221	5	0.9922480620155039	GTGGGACTACGAAGCTGAATGTCCTTTCTC GTGGGACTATGAAGCTGAATGCCCCTTCTC GTGGGATTATGAAGCTGAATGCCCCTTTTC GTGGGATTATGAAGCTGAATGTCCATTCTC GTGGGATTATGAAGCTGAATGTCCTTTCTC	20435	5	0.9922480620155039	CCTGTAAGTACTATTGGGAATAAACCTGTC CCTGTAAGTACTGTAGGAAACAAACCTGTC CCTGTAAGTACTGTGGAAAACAAACCTATC CCTGTAAGTACTGTGGGAAACAAACCCGTC CCTGTAAGTACTGTTGGAAATAAACCTGTC	2	0.9844961240310077	AGCAAGTGTGTGCTTACACTGATCTTGA ATAGTGAAGTTGTAACATGTTTTGATAA	{20262} {20289}
