cost	target-start	target-end	target-length	left-primer-start	left-primer-num-primers	left-primer-frac-bound	left-primer-target-sequences	right-primer-start	right-primer-num-primers	right-primer-frac-bound	right-primer-target-sequences	num-guides	total-frac-bound-by-guides	guide-target-sequences	guide-target-sequence-positions
2.5126942636811997	16925	17013	88	16925	1	1.0	AGCTGTGGACTCTTTATGTGTGAAGGCTAG	16983	1	1.0	CGTATAATACCAGCACGTGCTCGTGTTGAG	1	1.0	TAAAAATTATGTTGTGGATCATTGCTCC	{16955}
2.534811090344213	26539	26629	90	26539	1	1.0	CTCAATTTTCGATGCATGGTCGACATTTGG	26599	1	1.0	CGTTATGGCCTGCACAACACTAGTGCTGTG	1	1.0	GCAGAAGTGGGTTATGTTTGCTTTTAGC	{26569}
2.5453224201679636	19098	19189	91	19098	1	1.0	GATGATGGTGATTGTGACAGTGTGCAAGGT	19159	1	1.0	ATTGCATTACACGTTGTAACATTGGTGGTG	1	1.0	AGTGTAAATTATGTGCCTCTCAGAGCTT	{19128}
2.565364373321448	28383	28476	93	28383	1	1.0	TTCTGGAGTAATCAAAGATCCGCTTAGACG	28446	1	1.0	CATGCTATAGTTAGTAGTTGTAGATGGGTG	1	1.0	ATATGGAAGAGCTAGAACATATGTGCTA	{28418}
2.5749342433258255	28343	28437	94	28343	1	1.0	CTGCCCTTAGATCAAAGCTATATGCATTAG	28407	1	1.0	TAGACGAGCCTATATGGAAGAGCTAGAACA	1	1.0	TACCTCTATGTTCTGGAGTAATCAAAGA	{28373}
2.5842266863651715	59	154	95	59	1	1.0	CTCCCCTCAACTAAACGAAATTTTTGCCAT	124	1	1.0	AACATACTTGCACAAGTGTCGTGCATGTCG	1	1.0	TGGCTAATTGAAATTTCAGTCGGTTGTT	{96}
2.6020405378427527	12249	12346	97	12249	1	1.0	TGCAGCATGTGCTACAAAACTTACCATAGT	12316	1	1.0	CTAGGTAATGTTCAGTATGCAGGTGTGGTT	1	1.0	TGATTTTGAATCATTCAAGCGCATCTTT	{12285}
2.6105894934871645	11525	11623	98	11525	1	1.0	ACATGGTTGCTAATGATCTTCGTGCTCCTA	11593	1	1.0	ATGGGTCTGGGTGGTGAGAGAACTATTAAG	1	1.0	CAGGTGTTTTTGATTCAATGTCACTTAG	{11555}
2.6237942636811997	237	325	88	237	1	1.0	TACGTTCCGTCGTGCTTGAAACCGATAACT	295	1	1.0	TTGGCTTTTGCCAGTGATTCGGAGATTTCT	2	1.0	AGCAGGTATGCAGTCCAACCTTGTGACG AGCAGGTATGTCGTCCAACCTTGTGACA	{267} {267}
2.6237942636811997	27153	27241	88	27153	1	1.0	TTTCCTTAAGTCTATGCCTGGTAATGGTGT	27211	1	1.0	CAAATCGGATATTGGACAGAACAACGACGC	2	1.0	ACCAAAGGGTATGGGCGAGAAAAGTGAG ACCAAAGGGTATGGGCGGAAAAGCCGAG	{27183} {27183}
2.645911090344213	26797	26887	90	26797	1	1.0	GCTCCTTGTGGAGGGCATACCGGTTGCTAA	26857	1	1.0	CGTAACTGTTGCCAAAGCTACCACTACAAT	2	1.0	CGGAATCACGGTAGGACAACTACCTGAG CGGAATCACGGTGGGACAACTACCTGAA	{26827} {26827}
2.6575857056612073	26966	27070	104	26966	1	1.0	GACTATTCTGCTATTATGACGATGGCAGAT	27040	1	1.0	ACAAGAAAACCTGATATGGCTTCTGTTCAG	1	1.0	TCATTTTCCGAAAATGAAAGATTGTTAC	{26996}
2.6575857056612073	27402	27506	104	27402	1	1.0	ACGTAATCGCAACCAGCAATTGCGTATTCC	27476	1	1.0	CTGACAGCAGACCTGCTTCACGCTCTAACT	1	1.0	CTACCTGATAGTCTTGAGATTGTTAACT	{27448}
2.6666	27822	27914	92	27822	1	1.0	TGTTGAGAGAAACTGTGGATCAGCTTCTGT	27884	1	1.0	CTCAGATTGCTGAATTGATTCCTACTCAGG	2	1.0	GCAATGGGTGTAGAAACACCTAACTTTC TGGAATGGGTGTTGAAGCACCTAATTTT	{27856} {27855}
2.6718354666358684	15906	16012	106	15906	1	1.0	ACTTTGCTTGAAGATTCCAGTTCGAAGTTC	15982	1	1.0	TGCAGGCTTCTGGGTTATGCGTTGTTTGCG	1	1.0	GCTAGTTTATATGAAAAGAGTTCTGTCT	{15954}
2.6718354666358684	26408	26514	106	26408	1	1.0	AACTTCAGCTGGAACATAGTGCTTACTGTC	26484	1	1.0	TGTATGGTTTGAAAATGCTTGTGCTTTGGC	1	1.0	TTTTTGATAGTAATGCAGTATGGTCATT	{26438}
2.678729642842771	16183	16290	107	16183	1	1.0	GTGGCCTTAGCTACTATTGCATTGATCATA	16260	1	1.0	CTTTACAAAAATTCAGCCACTGGTTCACCT	1	1.0	CCAACTTTGGCTTTTCCATTGTGTTCAA	{16215}
2.7131405378427527	17105	17202	97	17105	1	1.0	GGTGGATGAAGTGTCCATGTGTACTAATTA	17172	1	1.0	CATATTGTATATGTTGGTGATCCACAGCAG	2	1.0	CTGTCATTAACCAAAGGGTTTCTTACAG TTTGTCTGTTATAAACCAAAGGGTTTCA	{17143} {17138}
2.7216894934871645	27072	27170	98	27072	1	1.0	TGAAGATACCAACTCTCGTGGTCGTTCTGG	27140	1	1.0	CTGATGACAAGCTTTTCCTTAAGTCTATGC	2	1.0	CACTATCCTATTATGCTCCTGTGCGTGT CTATCTTACTATGCTCCTCTGCGTGTTG	{27110} {27112}
2.7461433771173467	24725	24814	89	24725	1	1.0	CTGCATTTATTGAAGTCTCTGCCTTTGCTG	24784	1	1.0	CTTAGAGGTCGTGATGAGGTTTTGTTTCAA	3	1.0	GAGTTTGCGTCGATGGCAGAGCATTGGT GAGTTTGTGTTGATGGTAGAGCACTGGT GTGTCTGTGTTGAAGGAAGAGCATTGGT	{24755} {24755} {24755}
