cost	target-start	target-end	target-length	left-primer-start	left-primer-num-primers	left-primer-frac-bound	left-primer-target-sequences	right-primer-start	right-primer-num-primers	right-primer-frac-bound	right-primer-target-sequences	num-guides	total-frac-bound-by-guides	guide-target-sequences	guide-target-sequence-positions
2.5239433771173467	17971	18060	89	17971	1	0.9909255898366606	AGTAAGCACTGTGAGCGCTCTTGTCTACAA	18030	1	0.9909255898366606	CAGGCCAGTGCTTTAAAATACTCTATAAGG	1	0.985480943738657	TAATAAATTGTTAGCCAAGAAGGTGCTT	{18001}
2.534811090344213	19442	19532	90	19442	1	0.9945553539019963	GTTGATGACCCTGTGGTTGATTGGCATTAT	19502	1	0.9909255898366606	CAACAGCTTTTCTATACAGAGGACATGGCC	1	0.9872958257713249	TTTGATGCACAGCCCTTGACCAGAAAGG	{19472}
2.6270324226839716	18346	18446	100	18346	1	0.9909255898366606	TTGTGTTATGACATCTCAGGCACTCTTTGA	18416	1	0.9909255898366606	CTCCAGTCTCAGATTGTAACTGGCCTTTTT	1	0.9909255898366606	GTCCTTAGAGTTTACTGAATTGTCTTTT	{18376}
2.6647897580044537	10970	11075	105	10970	1	0.9909255898366606	GCATTTGATGGTACTATGTATGGTGCCTTT	11045	1	0.9909255898366606	AGTGTTAATGTAGTAGCTTGGCTTTACGCA	1	0.9909255898366606	ATGGACAAACAAGTGCACCAGATTCAGT	{11000}
2.6647897580044537	13953	14058	105	13953	1	0.9909255898366606	GGTTGCTGGTATTGGAAAATACTACAAGAC	14028	1	0.9909255898366606	AGACTCCTATTTTGTCGTTAAGAGGCATAC	1	0.9909255898366606	TGTAGAATTAGATGACCAAGGGCATCAT	{13998}
2.6647897580044537	16822	16927	105	16822	1	0.9981851179673321	GGTGGTATGAGCTACTTTTGTGTAGATCAT	16897	1	0.9945553539019963	GGCTTATACAAGAATATGTGCACAGGTAGT	1	0.9891107078039928	ACCTGTGTGTAGTTTTCCACTTTGCGCT	{16854}
2.678729642842771	13454	13561	107	13454	1	0.9909255898366606	GTTAACTTCACCGTTGATCCTCAAAAAGCT	13531	1	0.9909255898366606	TAAGATGCTTACTCCTAAAACTGGTACAGG	1	0.9872958257713249	CTCGATTTCGTCAATGCGGGAGGTGCCC	{13487}
2.6953266863651715	7928	8023	95	7928	1	0.9909255898366606	CATTCTGTCGTAGGCATAATTGGAATTGTG	7993	1	0.9909255898366606	ATCTGTGAAGAAGTCGCAAATGACCTCACT	2	0.985480943738657	TGGATTGTGACGCTGCAGGTGTGGGGAA TGGATTGTGATATTGCAGGTGTGGGGAA	{7958} {7958}
2.751623285568201	13536	13655	119	13536	1	0.9909255898366606	TGCTTACTCCTAAAACTGGTACAGGTATAG	13625	1	0.9909255898366606	TGTCTCTATTGCCGTGCGCATATAGAACAT	1	0.9909255898366606	CTATATCTGTGAAACCAGAGAGTACAGC	{13566}
2.751623285568201	17971	18090	119	17971	1	0.9909255898366606	AGTAAGCACTGTGAGCGCTCTTGTCTACAA	18060	1	0.9909255898366606	GCAATGTGACGCATGATGCTAGCTCTGCCA	1	0.985480943738657	TAATAAATTGTTAGCCAAGAAGGTGCTT	{18001}
2.757011090344213	14630	14750	120	14630	1	0.9945553539019963	AGTGGCCACTTACTGAGTATGATTTTACTG	14720	1	0.9909255898366606	ATTGCGTTAATTGTACTGATGACCGTTGTG	1	0.9963702359346642	ATTATAAGGTACAACTCTTTGAGAAGTA	{14660}
2.7623098364064735	9257	9378	121	9257	1	0.9909255898366606	CTACATTGGCTTGGGTGAACAATCAGATAA	9348	1	0.9909255898366606	GATACCCTATAAGAGTTTCTCTGATAGTGG	1	0.9909255898366606	CTCGAGTCTTTGCTAATACAGGCAGTGT	{9299}
2.7971342433258255	13775	13903	128	13775	1	0.9909255898366606	ATTGGATATGGGTGCAATTGTGACTCGCTT	13873	1	0.9909255898366606	GCCCGAATAGAACCCTGTTCAAGTGGTTTG	1	0.9836660617059891	AGGCAAGCAGCACTGCCCCAATCCAAGG	{13805}
2.7971342433258255	19503	19631	128	19503	1	0.9909255898366606	AACAGCTTTTCTATACAGAGGACATGGCCT	19601	1	0.9909255898366606	GTATGCAGGTTTGACACACGTGTGCATTCT	1	0.9927404718693285	CAAGATTTGCTGATGGGCTCTGCTTATT	{19533}
2.8064266863651715	14736	14866	130	14736	1	0.9909255898366606	TGATGACCGTTGTGTGTTACATTGTGCTAA	14836	1	0.9909255898366606	GATGGCGTGCCATTTGTAGTATCTTGTGGT	1	0.9909255898366606	GTTTGCTATGACCATGCCTAAGACTTGT	{14778}
2.8109738099539405	9150	9281	131	9150	1	0.9909255898366606	ATGGTATCATGAGCATGTTGGTGGTGTCTA	9251	1	0.9909255898366606	TACCTACTACATTGGCTTGGGTGAACAATC	1	0.9872958257713249	GGAGTTGCTGGTGCTCGCATTCCAGACG	{9223}
2.8154573353204815	8576	8708	132	8576	1	0.9909255898366606	CTGTGCAGTATGCTCATAAACATGACATAC	8678	1	0.9909255898366606	TAGGTAGTCTCATTGATTGTAATGCGGCTT	1	0.9872958257713249	CTCATATGTTAAACCTGATAGTGTGTCT	{8640}
2.836979969342407	6295	6432	137	6295	1	0.9909255898366606	GGGTTTGATTCTAGTAAACCAGTCACTAAG	6402	1	0.9909255898366606	TAAGAATGGTGCCATGTATAAAGGCAAACC	1	0.9872958257713249	GCGATGTGTTGTTGGCTGAGTTTGACAC	{6359}
2.8411163730311917	13633	13771	138	13633	1	0.9909255898366606	TTGCCGTGCGCATATAGAACATCCTGATGT	13741	1	0.9909255898366606	GTCAAATACCCCCTGTAATGTCTGTCAATA	1	0.9872958257713249	GTTTGTCCAAATCCCTGCTCAGTGTGTC	{13690}
2.8452000822449524	13345	13484	139	13345	1	0.9909255898366606	TCTTAACAACCTTCATCGCGGGCAAGTGTT	13454	1	0.9909255898366606	GTTAACTTCACCGTTGATCCTCAAAAAGCT	1	0.9927404718693285	CACCGAGTTTGCCTCTAATTCTTCGGTG	{13417}
