cost	target-start	target-end	target-length	left-primer-start	left-primer-num-primers	left-primer-frac-bound	left-primer-target-sequences	right-primer-start	right-primer-num-primers	right-primer-frac-bound	right-primer-target-sequences	num-guides	total-frac-bound-by-guides	guide-target-sequences	guide-target-sequence-positions
2.6349480554261384	161	262	101	161	1	1.0	TTCTCTGCCAGTGACGTGTCCATTCGGCGC	232	1	1.0	AATACGGTCTCGGCTTCAAATGGGCCCCAG	1	1.0	ATAGGTTGCATAATGGCAAAGATGGGCA	{204}
2.7405681611474058	29392	29509	117	29392	1	1.0	CGAGCCGTAGCATGTTTATTTATGTTGTGA	29479	1	1.0	GCGTGTATGCGCTAAATAATGTGTATCTTG	1	1.0	CACTGACTATTGTTTTGTGTATTTTCAA	{29449}
2.751623285568201	290	409	119	290	1	1.0	GGAGAAGTTGGGTAACCCTGAGAGGTCAGA	379	1	1.0	TTAATCACGTGAGGGTGGATTGTAGCCGGC	1	1.0	GGAGGATGGGTTTTGCCCCTCTGCTGCG	{320}
2.7875643733214486	330	456	126	330	1	1.0	TTTTGCCCCTCTGCTGCGCAAGAACCGAAA	426	1	1.0	TGTGTTCAGTCTGCCATAATCCGTGATATT	1	1.0	TGAGGGTGGATTGTAGCCGGCTTCCAGC	{388}
2.8154573353204815	161	293	132	161	1	1.0	TTCTCTGCCAGTGACGTGTCCATTCGGCGC	263	1	1.0	ATTTCCATGGATGCTTCCGAACGCATCGGA	1	1.0	ATAGGTTGCATAATGGCAAAGATGGGCA	{204}
2.8242405378427526	20403	20500	97	20403	1	1.0	CAGCGGTAATGAAGCTCTAGCGCGTGGCAC	20470	1	1.0	CCTCGATCAGAGATGGAGAAAGATTTTATG	3	1.0	ATCTTTACTCAAAGCAGATTTTTGTCCT CTCAAAGTAGATTATTATCCTCTTTCGC TATCTTTACGCAAAGCAGATTATTATCC	{20434} {20441} {20433}
2.8516681611474057	19254	19371	117	19254	1	1.0	TGATGCCTCCCCTGTTGTTAAGTCTGTTAA	19341	1	1.0	GTTTTGGAACTGCAATGTGGATAAGTATCC	2	1.0	ACAGTTCGTTTATAAGTATGAGGCACAT ACAGTTTGTTTATAAGTACGAGGCACAT	{19284} {19284}
2.868111090344213	427	517	90	427	1	1.0	GTGTTCAGTCTGCCATAATCCGTGATATTT	487	1	1.0	CCTCAACTATGATGGCATTGCAGTTCGGTA	4	1.0	GTAGATGAGGATCCCCAGAAGGTGGAGG GTTGACGAGGATCCCCAGAAGGTGGAGG GTTGATGAGGATCCCTTGAATGTGGAGG TGTTGATGAGGATCCCCAAAAGGTGGAG	{459} {459} {459} {458}
2.8786224201679635	385	507	122	385	1	1.0	ACGTGAGGGTGGATTGTAGCCGGCTTCCAG	477	1	1.0	AAGGTGGAGGCCTCAACTATGATGGCATTG	2	1.0	CAGTCTGCCATAATCCGTGATATTTTTG TGATATTTTTGTGGATGAGGATCCCCAG	{432} {449}
2.8786224201679635	11811	11933	122	11811	1	1.0	GTTATGTGTGTTGTTGTTATTGGGGAGTCT	11903	1	1.0	CAGGAGTTACGTTATATGAATGCTAATGGC	2	1.0	AATAGCATTTTTAGGATGCCATTTGGCG GTCACTCCTTAATAGCATTTCTAGGATG	{11852} {11842}
2.8786224201679635	29921	30043	122	29921	1	1.0	GGACACCGCATTGTTGAGAATCTAATCTAA	30013	1	1.0	CCGCGCTGGTAATGGAATCCTCAAGAAGAC	2	1.0	AAGGATGTCTTTTGTTCCCGGGCAAGAA TGGGCAAGAAAATGCCGGTAGCAGAAGC	{29956} {29974}
2.900929642842771	21315	21469	154	21315	1	1.0	GGAGTACAACGTGAGTAAAGATGGATTCTT	21439	1	1.0	AGTTTAATGGGGAAGTTTGCGTTTTGGACA	1	1.0	CTCTGTCATTTAATTTGTGACAAGTTGG	{21352}
2.9043219161711367	82	237	155	82	1	1.0	TAAACGGCACTTCCTGCGTGTCCATGCCCG	207	1	1.0	GGTTGCATAATGGCAAAGATGGGCAAATAC	1	1.0	TTGACTTTCGTTCTCTGCCAGTGACGTG	{151}
2.91100063353398	20246	20403	157	20246	1	1.0	GCGTAGTTGTGGAGAAAGTTGGAGATTCTG	20373	1	1.0	TAATCCGGGTGGTAATCGCGTGGGTGATCT	1	1.0	AGGGAGCCTTGAACCGAGCCATTACCGG	{20334}
2.9142885273623995	82	191	109	82	1	1.0	TAAACGGCACTTCCTGCGTGTCCATGCCCG	161	1	1.0	TTCTCTGCCAGTGACGTGTCCATTCGGCGC	3	1.0	GCTGACATTTGTGATTCCTTGGTTTTTG TCTTGTCATAGTGCTGACATTTGTGGTT TCTTGTCATAGTGCTGATACTTGTGGTT	{133} {121} {121}
2.927112910986066	161	323	162	161	1	1.0	TTCTCTGCCAGTGACGTGTCCATTCGGCGC	293	1	1.0	GAAGTTGGGTAACCCTGAGAGGTCAGAGGA	1	1.0	ATAGGTTGCATAATGGCAAAGATGGGCA	{204}
2.9353405378427526	11738	11872	134	11738	1	1.0	TTGGCTGTGAATGTCTTGTACTTCACAGAC	11842	1	1.0	GTCACTCCTTAATAGCATTTTTAGGATGCC	2	1.0	GCTATTTGTGTATAGGTTATGTGTGTTG GCTATTTGTGTATTGGTTATGTGTGTTG	{11796} {11796}
2.9353405378427526	21481	21615	134	21481	1	1.0	AACGTAAACGCCTCTTCAAGTGAAGGATTT	21585	1	1.0	TTGGAGAAATAGTACAATGTGGAATGGAGG	2	1.0	TTGATTGGCATAAATTGGTTAAATAGGA TTGGCATAAACTGGTTGAATAGAAACCG	{21511} {21515}
2.9394439250039426	20122	20235	113	20122	1	1.0	TTTGATGGTCGTGATAATGGTGCTCTTGAA	20205	1	1.0	TCTGTCGATGATTAAAGGCCCACAACGTGC	3	1.0	AGAAGTGCCGGAATGGCGTCTACATTAA GCATTTAAGAAAGCCCGGAATGGCGTCT GCTTTTAAGAAGTGCCGGGATGGTGTCT	{20159} {20152} {20152}
2.9710950406914325	330	507	177	330	1	1.0	TTTTGCCCCTCTGCTGCGCAAGAACCGAAA	477	1	1.0	AAGGTGGAGGCCTCAACTATGATGGCATTG	1	1.0	TGAGGGTGGATTGTAGCCGGCTTCCAGC	{388}
