cost	target-start	target-end	target-length	left-primer-start	left-primer-num-primers	left-primer-frac-bound	left-primer-target-sequences	right-primer-start	right-primer-num-primers	right-primer-frac-bound	right-primer-target-sequences	num-guides	total-frac-bound-by-guides	guide-target-sequences	guide-target-sequence-positions
3.8411163730311912	26652	26790	138	26652	1	1.0	TTTGAACGAACCTATTATGTCTGGACGGAA	26760	2	1.0	CCGTAATGGTAACCGTAATGGTGCCCGTCC CCGTAATGGTAACCGTTCTGGTGCCCGTTC	4	1.0	ACAAGAATCTGACGGTTCTGACTCCGAA CCCCGGCAGTCAATCACCTAAGGTGACG CTGATAATTCTGACTCCGAATCTGAACG GTTCAAACAGGAATCTGACGGTTCAGAC	{26724} {26691} {26732} {26718}
3.8460942636811994	12207	12295	88	12207	2	1.0	ACACGTGAGAATAGTGTAAACTTGGCATGG ACGCGCGAGAATAGTGCTAACTTGGCATGG	12265	2	1.0	AGGCCACATCACCTGTCAAGTTGCAGAATA TGGCCACATCACCTGTCAAATTGCAAAATA	1	1.0	CCGTTAGTAGTAACGGCGCAGCGGCAGC	{12237}
3.966287395870145	9557	9780	223	9557	2	1.0	GGCCCTAGAGAAATATTCTAATGGTGGTGG GGCTTTAGAAAAGTATTCTAATGGTGGTGG	9750	1	1.0	TGTCCTAGACATGTTATGTGTTCTAGGGAT	3	1.0	ACAAGCTGGTTTAACGCGCATGGCCCAT CACGTATGGCTCACCCTTCAGGTTTAGT TCGCTGTAGTGTAGCATCAGCTGCATTA	{9635} {9649} {9608}
4.293732422683972	18316	18456	140	18316	2	1.0	ATGCTGGAGTCACCATAGACACATAGGAGG ATGCTGGAGTCACCATAGACACATTGGCGG	18426	2	1.0	ATGTCTGCGAAGTTCACAGGGGTGCACATG ATGTCTGCGATGTCCATAAGGGTGCACATG	2	1.0	ATGTAGGTAACCTACAGGTAAACCATGA ATGTAGGTAATTTACAGGTAAACCATGA	{18396} {18396}
4.297714670640963	9752	9893	141	9752	1	1.0	TCCTAGACATGTTATGTGTTCTAGGGATGA	9863	3	1.0	CCGGGTTGTAGGACATGTTATGGAGGGTTC TAGAGTTATAGGTCATGTTATGGTGGGTTC TCGTGTTATAGGCCATACTATGGAAGGTTC	2	1.0	CGAGCTGCTAATTATGATTTTCACGTGT TGCGAGCAGCTAATTATGATTTTCATGT	{9816} {9814}
4.362026686365172	18271	18401	130	18271	2	1.0	CCCAAAACGTGCAACCCTGTTTAGTAGTGT TCCTAAGCGTGCAACCTTATTTAGTAGTGT	18371	2	1.0	CTGGTGGATGTGCAGCAATGGGGTTATGTG TTGGTGGATGTACAGCAATGGGGTTATGTA	3	1.0	GAGCATATTCATGCTGGAGTCACCATAG GGGCATATTCTTGCTGGAGTCACCATAG TGGGGCATATTCATGCTGGAGTCACCAT	{18306} {18306} {18304}
4.5139225926641835	18310	18529	219	18310	1	1.0	ATATTCATGCTGGAGTCACCATAGACACAT	18499	3	1.0	CGACTGTTTCTGTAGTGAAGTTAATTGGGA TGACTGTTTCTGTGGTGAAGTCAATTGGGA TGATTGCTTTTGCGGTGAAGTTAATTGGGA	2	1.0	ATGTAGGTAACCTACAGGTAAACCATGA ATGTAGGTAATTTACAGGTAAACCATGA	{18396} {18396}
4.5139225926641835	26652	26871	219	26652	1	1.0	TTTGAACGAACCTATTATGTCTGGACGGAA	26841	3	1.0	AGCCCCTCCGCAGAATGTTTCTTGGTTTGC AGCCCCTCCTCAGAATGTTTCTTGGTATGC TGCCCCTCCTCAGAATGTTTCCTGGTTTGC	2	1.0	ACTCCGAATCGGAACGCCGTAATGGTAA TCTGGTACACCTTCCCCTAAGGTCACGT	{26744} {26692}
4.555465756109888	18091	18332	241	18091	3	1.0	ACCACTTATGCGTAAGGGCGAGCCTTGGAG ACCACTTATGCGTAGGGGTGAGCCTTGGAG ACCTCTCATGCGTAAAGGTGAGCCATGGAG	18302	1	1.0	TATGGGGCATATTCATGCTGGAGTCACCAT	2	1.0	ACGCATTGTAGAGATGCTTTGTGATACT GTAAGTGCTTTATGTGTCCTAAACGTGC	{18133} {18255}
4.558988504066714	14162	14405	243	14162	2	1.0	TATGCAGCAGATCCTGCTATGCATGTGGCG TATGCGGCTGATCCCGCTATGCACGTTGCG	14375	2	1.0	GATGGCAATGCTGCCATCTCTGATTATGAT GATGGTAATGCAGCTATCTCTGATTATGAC	2	1.0	ATAATTTTGCTGTAAAGTGTGGCTTCTT TTTACAAATTTGCTGTAAAGTGTGGCTT	{14301} {14298}
4.571021916171136	11628	11783	155	11628	2	1.0	CCAGGTGCTATAAACTTGGATGAGTTGTGT CCGGGAGCAATTAATTTGGATGAGTTATGT	11753	2	1.0	TTATGATACAGCTGTATCCACTGGGGCCCC TTATGATACAGCTGTTGCCACAGGTGCACC	4	1.0	AACAGTATATTGGAGAACAATACTGTGC GCATTTTGGAAAATAATTCTGTTCTCCA GGCTGTTGCTAGTGAGTTTAGTAATTTA TAGCATTTTGGAGAACAATTCTGTTCTG	{11658} {11662} {11690} {11660}
4.6351433771173465	18367	18456	89	18367	3	1.0	ATTCCTGGTGGATGTACAGCAATGGGGTTA ATTTTTGGTGGATGTACAGCAATGGGGTTA TTTTCTGGTGGATGTGCAGCAATGGGGTTA	18426	2	1.0	ATGTCTGCGAAGTTCACAGGGGTGCACATG ATGTCTGCGATGTCCATAAGGGTGCACATG	2	1.0	TGTAGGTAACCTACAGGTAAACCATGAT TGTAGGTAATTTACAGGTAAACCATGAC	{18397} {18397}
4.650216028494806	12233	12465	232	12233	1	1.0	ATGGCCGTTAGTAGTAACGGCGCAGCGGCA	12435	3	1.0	GGTCTAGCCTTTGCTAAGGTTGAAAAGTCT GGTCTAGCTTTTGCGAAGGTTGAGAAGTCG GGTTTAGCCTATGCCAAAGTAGAAAAGTCT	3	1.0	CAAACTGTTAAGCGTATGAATGTAGTAG CGCAGGCAGTTAAGCGTATGAATGTCGT GTTGCTGGTGTAAGCCAAACTGCTTGTG	{12309} {12307} {12333}
4.764926723086379	76	259	183	76	2	1.0	CTTAAAATTGCATCATACGTCACAGTGGGT CTTAAAATTGCATCATACGTCACGGTAGGT	229	2	1.0	TGATGGAAGGTGTGCCTGACCCACCTAAGC TGATGGAGGGTGTGCCTGGTCCATCTAAGC	5	1.0	CTGTGCGTAAGTTGCACACAAATTTTAG GCACACCAATTATAGTGGAGCTTTTTGG GTGCGTAAGTTGCACACCTATTTTAGTG TGCGTAAGTTGCACAAACAACTTAGTGA TTCGTCTTGCTGTGCGTAAGTTGCACAC	{115} {128} {117} {118} {106}
4.809764845367943	18000	18110	110	18000	2	1.0	CACCTAGTGGGTACGTAGATACTGAATCAG CGCCTAGTGGTTATATAGATACAGAATCTG	18080	3	1.0	AAACATTTGATACCACTTATGCGTAAGGGC AAACATTTGATACCACTTATGCGTAGGGGT AAGCATTTGATACCTCTCATGCGTAAAGGT	2	1.0	ACGTGGTATCTAAGGCACCACCTGGTGA GATTGGCCAATGTGGTGTCAAAGCCACC	{18045} {18036}
4.840318128345179	29471	29586	115	29471	2	1.0	CGGTATAAGTAAGTTGTGCATTCGCTATGT TGGTATAAGTAAGCTGTGCATTCGCTATGT	29556	3	1.0	AAGCGCCTTAGGGAAGAGCTAATCAGTAAT AGGCGCCTACGGGAAGAGCTAATCAGTAAT AGGTGCCTACGGGAAGGGCTAATCAGCAAT	2	1.0	AGAGTTTAGTTTAGTGCTAGTTGATTAG TTAGGTTTAGAATGTAGTTTAGTGCTAG	{29509} {29501}
4.849332422683973	18243	18343	100	18243	3	1.0	TAGGACCTGAACGCAAATGTTTTATGTGTC TGGGACCAGAGCGTAAGTGCTTTATGTGTC TTGGGCCAGAGCGTAAATGCTTTATGTGCC	18313	2	1.0	TTCATGCTGGAGTCACCATAGACACATAGG TTCATGCTGGAGTCACCATAGACATATTGG	3	1.0	AACCTTATTTAGTAGTGTTTATGGGGCA CCCTGTTTAGTAGTGTGTATGGAGCATA CTAAGCGTGCAACCCTATTTAGTAGTGT	{18283} {18285} {18273}
4.887089758004454	12145	12295	150	12145	3	1.0	GTGCGTGGGATGTTATGCAGGTTGCAGATG GTGCGTGGGATGTTATGCAGGTTGCTGATG GTGCTTGGGATGTTATGCAAGTTGCGGATG	12265	2	1.0	AGGCCACATCACCTGTCAAGTTGCAGAATA TGGCCACATCACCTGTCAAATTGCAAAATA	1	1.0	CCGTTAGTAGTAACGGCGCAGCGGCAGC	{12237}
4.968348055426138	14263	14405	142	14263	3	1.0	CCAAACGGTTAAGCCCGGTCAGTTTAATGA TCAGACCGTTAAACCAGGGCAGTTTAATGA TCAGACTGTCAAACCAGGGCAGTTTAATGA	14375	2	1.0	GATGGCAATGCTGCCATCTCTGATTATGAT GATGGTAATGCAGCTATCTCTGATTATGAC	2	1.0	ATAATTTTGCTGTAAAGTGTGGCTTCTT TTTACAAATTTGCTGTAAAGTGTGGCTT	{14301} {14298}
5.019434243325826	26554	26682	128	26554	4	1.0	GTACAAAATACCACAGAAGATGGAGATCGT GTGCAGAATACCAATGAAGATGGCGAGCGC GTGCAGAATACCACAGAGGATGGTGATAGG GTTCAGAATAACAATGAAGATGGCGAGCGT	26652	1	1.0	TTTGAACGAACCTATTATGTCTGGACGGAA	3	1.0	CATGTTGTATATATTTCCTTCTTTATAA CTAGCTATGTTTGTTGCTTAATGAAATA TTAGCTATGTTTGTTGCTTAAAGAAATA	{26624} {26584} {26584}
