cost	target-start	target-end	target-length	left-primer-start	left-primer-num-primers	left-primer-frac-bound	left-primer-target-sequences	right-primer-start	right-primer-num-primers	right-primer-frac-bound	right-primer-target-sequences	num-guides	total-frac-bound-by-guides	guide-target-sequences	guide-target-sequence-positions
2.6985648453679434	25857	25967	110	25857	1	1.0	ACTAGCCTGTCATATAGTAGGATAAGTAGG	25937	1	1.0	AAAGTGATTGAAAGATGCCTTTAAGGAGCC	1	1.0	ATGATTTTATTGTATTTAGTAGAAAGCA	{25891}
2.7172439250039426	15193	15306	113	15193	1	1.0	TGTTTATGTAGGTGATCCACAACAACTACC	15276	1	1.0	GTGTGACAAGGAGAATGTGTTTATTAGGAC	1	1.0	CCTCGTATTTTGATAACGCGAGGTGTTT	{15227}
2.7461433771173467	21818	21936	118	21818	1	1.0	ACAAGTGCAGGCAGAACAACAAATGGATCG	21906	1	1.0	GTGTCAGAGTTGACAAGTATTCAACAGTTG	1	1.0	AATGGGAAAATGAACGCACTTTTGAATT	{21855}
2.7777	21479	21603	124	21479	1	1.0	TATTGGTATGTATGGTGGCATTGTGGCAGC	21573	1	1.0	GCTCGTTTGAATGCTGTAGGTGTTACTCAG	1	1.0	ATGGGCCTTTTTGGAGGCCAAGTAACCA	{21519}
2.782670128054922	10190	10315	125	10190	1	1.0	GTTGCGTAGATTGGATATGTCTAGTGTTGA	10285	1	1.0	CTCGTATGATAGTTGTTGTTCCGACTAAAG	1	1.0	TTGAGTATTGTACCTGTTACTAGTGCTT	{10257}
2.836979969342407	10082	10219	137	10082	1	1.0	ACTTGAACGTTTAGCTGAAACAGCTGCAGC	10189	1	1.0	TGTTGCGTAGATTGGATATGTCTAGTGTTG	1	1.0	AAATGTATAAAGATGTTAGAGCCAGTGA	{10114}
2.8648729313414405	20833	20977	144	20833	1	1.0	ATACTCCTTGTGGTTGTCTTAGAAATGCAC	20947	1	1.0	GTACTGAGGTTGTTCCTATTGGTATTGTTG	1	1.0	TCATATAGTTGTAAAACTTTATTGAGTG	{20889}
2.8797857056612073	13933	14081	148	13933	1	1.0	GGATGATGCACAAAGTAAATTTTGGGAGGA	14051	1	1.0	TGTGGTGATTGTATACGTAGACCTTTGTTG	1	1.0	AGATTTTTATAAAAATTTGTATGAACGT	{13963}
2.8869897580044537	21818	21968	150	21818	1	1.0	ACAAGTGCAGGCAGAACAACAAATGGATCG	21938	1	1.0	TAAGCAGAAAGTTCAAGAATGTGTGCATGC	1	1.0	AATGGGAAAATGAACGCACTTTTGAATT	{21855}
2.927112910986066	24925	25036	111	24925	1	1.0	CTGCTTCTGGTAATAATACACCAAAGCAAG	25006	1	1.0	GAGTGCCCACTGGTAAAGAAAATATTACAG	3	1.0	AAAAGTGCAACGTAAACAAACTGAACGG AAAAGTTCAACGTAAGCAAATAGAACGG AAAGGTTCAACGGAAGCAAACAGAACGT	{24965} {24965} {24965}
2.96556788931984	20688	20863	175	20688	1	1.0	GTACCATGTATAAAAACTCGGCTTAGCGTT	20833	1	1.0	ATACTCCTTGTGGTTGTCTTAGAAATGCAC	1	1.0	GCTGGATTGTTGTCCAGAGATGGAATTA	{20805}
2.9682480554261383	11049	11191	142	11049	1	1.0	GCTTATGTTGAACATCCAACCGTAGATGGT	11161	1	1.0	GTAGTGTTTGTAAGTGTTGGATAGGTCATG	2	1.0	TAGGGACTAAAGATCCTGTGGGTTTTTG TTGGAACTAAAGATCCAGTAGGTTTTTG	{11116} {11116}
2.9721337616452868	24925	25068	143	24925	1	1.0	CTGCTTCTGGTAATAATACACCAAAGCAAG	25038	1	1.0	TGTTTTGGACCAAGAGGACCAGAACAAAAT	2	1.0	AAAAGTGCAACGTAAACAAACTGAACGG GCCCAGACACAAAAGAGTGCCCACTGGT	{24965} {24992}
2.9818714113224147	15285	15466	181	15285	1	1.0	GGAGAATGTGTTTATTAGGACCTGATGTCT	15436	1	1.0	GGGTCATGTACAAGTTGATAATGGTTCTAG	1	1.0	TTCAGGTAAATGTTTTAAAGTGTTTTTA	{15406}
2.9948515990016813	21592	21778	186	21592	1	1.0	GTGTTACTCAGGGTATGATTATGGAAGATG	21748	1	1.0	TGGCTAAAGCTACCATGGATAATTTTGGTG	1	1.0	TCAGTGTCTAAAATGGCCAGTGTTACAG	{21660}
2.9948515990016813	21750	21936	186	21750	1	1.0	GCTAAAGCTACCATGGATAATTTTGGTGCA	21906	1	1.0	GTGTCAGAGTTGACAAGTATTCAACAGTTG	1	1.0	AATTATTGAGAAACGGTTGAAACAAGTG	{21797}
2.9999	21818	22006	188	21818	1	1.0	ACAAGTGCAGGCAGAACAACAAATGGATCG	21976	1	1.0	TAAGAAATGGTTTTTGTGGTTCTGGCTTGC	1	1.0	AATGGGAAAATGAACGCACTTTTGAATT	{21855}
3.0023946961550467	10082	10271	189	10082	1	1.0	ACTTGAACGTTTAGCTGAAACAGCTGCAGC	10241	1	1.0	AGATGGTGTTGTACCTTTGAGTATTGTACC	1	1.0	AAATGTATAAAGATGTTAGAGCCAGTGA	{10114}
3.014585018119717	10943	11070	127	10943	1	1.0	GATGCTTTCTAATGGATCTGGTAATGGTCA	11040	1	1.0	TATTGTCGTGCTTATGTTGAACATCCAACC	3	1.0	AGCTGTAAGTTATACAGTAGATGCCAAA AGCTGTAAGTTATACAGTCGATGCCAAA AGCTGTAAGTTATACAGTTGATGCCAAA	{10973} {10973} {10973}
3.0286266863651714	21403	21603	200	21403	1	1.0	CAACTGTTAAGGATTTGGTTTGTGCGCAAT	21573	1	1.0	GCTCGTTTGAATGCTGTAGGTGTTACTCAG	1	1.0	ATGGGCCTTTTTGGAGGCCAAGTAACCA	{21519}
