cost	target-start	target-end	target-length	left-primer-start	left-primer-num-primers	left-primer-frac-bound	left-primer-target-sequences	right-primer-start	right-primer-num-primers	right-primer-frac-bound	right-primer-target-sequences	num-guides	total-frac-bound-by-guides	guide-target-sequences	guide-target-sequence-positions
2.6666	5752	5844	92	5752	1	0.9474497681607419	GGATGATTACAATGACGCTGTGCTTAGCGT	5814	1	0.9289026275115919	CAGTTGGACAAGTCACCAATTATGGCTTCT	2	0.9675425038639877	ACATCAAAATTTCCAAACATGTATATTC ATACATCAAAATTCCCAAATATGTATAT	{5786} {5784}
2.7131405378427527	5824	5921	97	5824	1	0.9088098918083463	AGTCACCAATTATGGCTTCTTGAACCTAGG	5891	1	0.9211746522411128	CCAACAAGAGCTGGCCAGTGTGGTGGTGTG	2	0.9443585780525502	GGTACACCGACGCACCGCATTTTAATGT TGGTACACCAACACACCGCATTTTAATG	{5855} {5854}
2.7623098364064735	6616	6737	121	6616	1	0.9443585780525502	TACAGCAACTGGTAGTGCAGTTGGTTGTGA	6707	1	0.9119010819165378	TACACTGGTTATGATGCTAGTTTGTCACCA	1	0.9829984544049459	GATATATTTTGGTCAAAAATCCCTATTT	{6650}
2.7971342433258255	3664	3792	128	3664	1	0.9072642967542504	ATATTACCCAGCAAGGTACCAGACCAATGT	3762	1	0.9057187017001546	TCGGTCTTCTTACAGCAGGAGGGGGTGGAA	1	0.9845440494590417	GGTTTACTAGTCTGTCCACATGGGGTAA	{3734}
2.8064266863651715	4708	4838	130	4708	1	0.9149922720247295	ATCTATGTTCTGCCAAATGGTCTCTACTGT	4808	1	0.9489953632148377	ACTACTAATGCTGGCTCAATACATGCACCA	1	0.9768160741885626	GGAACTCTGTACACCAGTCCATTTTTAA	{4775}
2.9438894934871644	5824	5960	136	5824	1	0.9088098918083463	AGTCACCAATTATGGCTTCTTGAACCTAGG	5930	1	0.9088098918083463	ACAGGTAAGGTGATAGGAATACATGTAGGT	2	0.9443585780525502	GGTACACCGACGCACCGCATTTTAATGT TGGTACACCAACACACCGCATTTTAATG	{5855} {5854}
2.9513181283451795	3622	3792	170	3622	1	0.9242658423493045	TTGCTTTGAAGGCCCAGGGATTCAATGGAT	3762	1	0.9057187017001546	TCGGTCTTCTTACAGCAGGAGGGGGTGGAA	1	0.9845440494590417	GGTTTACTAGTCTGTCCACATGGGGTAA	{3734}
2.9683433771173466	7214	7390	176	7214	1	0.9026275115919629	ATGGACTAAAGATCCCAGAAACACACAGGA	7360	1	0.9829984544049459	CTAGTCTTAGACGGAAATGGTTAGATTCGT	1	0.9876352395672334	GGAAGGGCATTGACACTACCTGCATACT	{7332}
2.9759729313414405	6735	6879	144	6735	1	0.9289026275115919	CAGTGTGGTTTGCCTGTTTAAAGAAAGTTC	6849	1	0.9412673879443586	ATAGTTAATGGTGGAATGCCCTCTGGTTCT	2	0.9613601236476044	AATTAGGTTACACACACCAAACATCTTT ATTAAGTTAGGTTACACACATCAAACGT	{6771} {6767}
2.9797666660097972	7214	7359	145	7214	1	0.9026275115919629	ATGGACTAAAGATCCCAGAAACACACAGGA	7329	1	0.9289026275115919	GTGGGAAGGGCATTGACACTACCTGCATAC	2	0.9922720247295209	AATTTTGCAGAAAAGTCAGAAGTGTGCC TAGGTCTTTGTGCTACCTCGCATGGCAT	{7300} {7250}
3.0023946961550467	3664	3853	189	3664	1	0.9072642967542504	ATATTACCCAGCAAGGTACCAGACCAATGT	3823	1	0.9227202472952086	ATGGTTAGATACTGATGCTATGGAACAAGG	1	0.9845440494590417	GGTTTACTAGTCTGTCCACATGGGGTAA	{3734}
3.0048701280549226	6547	6737	190	6547	1	0.9520865533230294	CTTGAATGACTCAGTTGCTATGAGGGTTGC	6707	1	0.9119010819165378	TACACTGGTTATGATGCTAGTTTGTCACCA	1	0.9829984544049459	GATATATTTTGGTCAAAAATCCCTATTT	{6650}
3.038212910986066	5965	6127	162	5965	1	0.9242658423493045	TGGAGCTCAAGGATTTGCAGCAATGCTACT	6097	1	0.9134466769706336	CCATCAAGTTTTTGAAGGTTCAAAGGAACC	2	0.9829984544049459	CTCTTACTTTACCGATACACAAGGTGAG CTCTTACTTTACTGACACACAAGGAGAG	{5998} {5998}
3.050543925003943	5824	5990	166	5824	1	0.9088098918083463	AGTCACCAATTATGGCTTCTTGAACCTAGG	5960	1	0.9629057187017002	GGAAATGGAGCTCAAGGATTTGCAGCAATG	2	0.9397217928902627	GGTACACCGACACACCGCATTTTAATGT GGTACACCGACGCACCGCATTTTAATGT	{5855} {5855}
3.057091578646307	239	452	213	239	1	0.9072642967542504	ATCCGCTATAGTACTTCGAGAAACCTAGTA	422	1	0.9088098918083463	AGGTGTGAAGAGTCTATTGAGCTACTATAG	1	0.8979907264296755	ACCTTTGGATTGTTGACGCGTTGCGCTC	{271}
3.0633163730311916	7172	7388	216	7172	1	0.9242658423493045	ACATCCAGTGATGCCAATGAAGGAGATACA	7358	1	0.9629057187017002	CTCTAGTCTTAGACGGAAATGGTTAGATTC	1	0.973724884080371	TGGGAAGGGCATTGACACTACCTGCATA	{7330}
3.0734297303170677	3040	3261	221	3040	1	0.9397217928902627	CCCAGCCAGAATGACCATACCTTTTATGTG	3231	1	0.9412673879443586	ACATGAAGCCTAAACACATAAAAGCATGGG	1	0.9860896445131375	TAGTGAATGAACACCAACCAGTTGGTTT	{3183}
3.0832337616452867	6866	7092	226	6866	1	0.9149922720247295	GCCCTCTGGTTCTTCAGGCACCAGCATATT	7062	1	0.9010819165378671	TTAGTAATGACACCAGCAGACAAAGGAACC	1	0.9752704791344667	ATTAGGGTTTACAAAGGCATAGACCTGG	{6936}
3.0927468288076465	3622	3853	231	3622	1	0.9242658423493045	TTGCTTTGAAGGCCCAGGGATTCAATGGAT	3823	1	0.9227202472952086	ATGGTTAGATACTGATGCTATGGAACAAGG	1	0.9845440494590417	GGTTTACTAGTCTGTCCACATGGGGTAA	{3734}
3.1056079683607334	4482	4720	238	4482	1	1.0	TCCAGTTCAAGTCCAAATCTCGCATTGAAC	4690	1	0.9350850077279753	TCCAGATGGGAATGACATATCTATGTTCTG	1	0.9845440494590417	CGGTTTGTTTAATAATACATGGCTCTCC	{4512}
