cost	target-start	target-end	target-length	left-primer-start	left-primer-num-primers	left-primer-frac-bound	left-primer-target-sequences	right-primer-start	right-primer-num-primers	right-primer-frac-bound	right-primer-target-sequences	num-guides	total-frac-bound-by-guides	guide-target-sequences	guide-target-sequence-positions
2.5126942636811997	356	444	88	356	1	0.9966160787530763	ACAGGATTTGCACCTTTCTCTAAGGACAAT	414	1	0.9973338802296965	TCTGGGTGACAAGAGAACCTTATGTGTCAT	1	0.9980516817063166	TCGATTAGGCTTTCCGCTGGTGGGGACA	{386}
2.5126942636811997	638	726	88	638	1	0.9944626743232158	GGAAAAGCATGGCTGCATGTTTGTATAACG	696	1	0.9973338802296965	TCATTTACAATGGGAGGCTTGTAGATAGTG	1	0.9982567678424938	GGGGATGATAAAAATGCAACTGCTAGCT	{668}
2.5126942636811997	691	779	88	691	1	0.9914889253486464	TAGCTTCATTTACAATGGGAGGCTTGTAGA	749	1	0.9914889253486464	CTCAGGACCCAGGAGTCAGAATGCGTTTGT	1	0.9900533223954061	TAGTGTTGTTTCATGGTCCAAAGATATT	{721}
2.5126942636811997	1136	1224	88	1136	1	0.993642329778507	GGCTGGGCCTTTGATGATGGAAATGACGTG	1194	1	0.9916940114848236	CACGCTTAGGGTATGAAACCTTCAAAGTCG	1	0.9927194421657096	TGGATGGGGAGAACAATCAACGAGACGT	{1166}
2.5126942636811997	1338	1426	88	1338	1	0.9981542247744053	GCAAAAGCTGCATCAATCGGTGCTTTTATG	1396	1	0.9924118129614438	AACTGAAGTCTTGTGGACCTCAAACAGTAT	1	0.9912838392124692	TGGAGTTGATTAGGGGAAGAAAAGAGGA	{1368}
2.6237942636811997	876	964	88	876	1	0.9935397867104184	CTAGCAAATTGTCAGGAAGTGCTCAGCATG	934	1	0.9911812961443807	TCCTGGTGTCAGATGTGTCTGCAGAGACAA	2	0.9967186218211649	TCGAAGAGTGCTCCTGCTATCCTCGATA TCGAAGAGTGCTCTTGCTATCCTCGATA	{906} {906}
2.6237942636811997	1210	1298	88	1210	1	0.9928219852337982	AACCTTCAAAGTCGTTGAAGGCTGGTCCAA	1268	1	0.9942575881870386	CAAGTCATAGTTGACAGAGGTGATAGGTCC	2	0.9954881050041017	CCCCAAGTCCAAATTGCAGATAAATAGG CTCTAAGTCCAAATTGCAGATAAATAGG	{1240} {1240}
2.7111377053709504	785	897	112	785	1	0.9972313371616078	GGAACTTGTACAGTAGTAATGACTGATGGA	867	1	0.9945652173913043	TCGTTCATACTAGCAAATTGTCAGGAAGTG	1	0.9988720262510254	TAAAATACTATTCATTGAGGAGGGGAAA	{838}
2.7726515990016813	691	814	123	691	1	0.9914889253486464	TAGCTTCATTTACAATGGGAGGCTTGTAGA	784	1	0.997436423297785	TGGAACTTGTACAGTAGTAATGACTGATGG	1	0.9900533223954061	TAGTGTTGTTTCATGGTCCAAAGATATT	{721}
2.8064266863651715	469	599	130	469	1	0.9928219852337982	TGCCCTTGGACAGGGAACAACACTAAACAA	569	1	0.9976415094339622	TTGGGTGTTCCTTTCCATCTGGGGACCAAG	1	0.9915914684167351	CGTGCATTCAAATAACACAGTACGTGAT	{499}
2.8109738099539405	752	883	131	752	1	0.9920016406890895	AGGACCCAGGAGTCAGAATGCGTTTGTATC	853	1	0.9933347005742412	TGAGGAGGGGAAAATCGTTCATACTAGCAA	1	0.998974569319114	GTACAGTAGTAATGACTGATGGAAATGC	{792}
2.8154573353204815	286	418	132	286	1	0.9909762100082035	AAGGAAATATGCCCCAAACCAGCAGAATAC	388	1	0.9968211648892535	GATTAGGCTTTCCGCTGGTGGGGACATCTG	1	0.9976415094339622	TACAGGATTTGCACCTTTCTCTAAGGAC	{355}
2.8154573353204815	580	712	132	580	1	0.9965135356849877	TTTCCATCTGGGGACCAAGCAAGTGTGCAT	682	1	0.9930270713699754	TGCAACTGCTAGCTTCATTTACAATGGGAG	1	0.9993847415914684	CTCAAGTTGTCACGATGGAAAAGCATGG	{622}
2.836979969342407	1289	1426	137	1289	1	0.9968211648892535	GATAGGTCCGGTTATTCTGGTATTTTCTCT	1396	1	0.9924118129614438	AACTGAAGTCTTGTGGACCTCAAACAGTAT	1	0.9912838392124692	TGGAGTTGATTAGGGGAAGAAAAGAGGA	{1368}
2.868111090344213	1033	1153	120	1033	1	0.9940525020508614	TGTGTGTTCAGGACTTGTTGGAGACACACC	1123	1	0.9957957342083675	TCATGGAGTGAAAGGCTGGGCCTTTGATGA	2	0.9949753896636587	CAGAAAAAGCGACAGCTCCAGCAGTAGC GCTTGAATCCTAACAATGAAAAAGGTGG	{1063} {1095}
2.923954591467449	752	913	161	752	1	0.9920016406890895	AGGACCCAGGAGTCAGAATGCGTTTGTATC	883	1	0.9970262510254306	ATTGTCAGGAAGTGCTCAGCATGTCGAAGA	1	0.998974569319114	GTACAGTAGTAATGACTGATGGAAATGC	{792}
2.927112910986066	286	448	162	286	1	0.9909762100082035	AAGGAAATATGCCCCAAACCAGCAGAATAC	418	1	0.9932321575061526	GGTGACAAGAGAACCTTATGTGTCATGCGA	1	0.9976415094339622	TACAGGATTTGCACCTTTCTCTAAGGAC	{355}
2.927112910986066	580	742	162	580	1	0.9965135356849877	TTTCCATCTGGGGACCAAGCAAGTGTGCAT	712	1	0.9955906480721903	GCTTGTAGATAGTGTTGTTTCATGGTCCAA	1	0.9993847415914684	CTCAAGTTGTCACGATGGAAAAGCATGG	{622}
3.395818128345179	1396	1511	115	1396	1	0.9924118129614438	AACTGAAGTCTTGTGGACCTCAAACAGTAT	1481	2	0.9948728465955702	CCTGATGGGGCGAACCTCAGTCTCATGCAT CCTGATGGGGCGGACCTCAATCTCATGCAT	1	0.999487284659557	CTCAGGTACATATGGAACAGGCTCATGG	{1453}
