cost	target-start	target-end	target-length	left-primer-start	left-primer-num-primers	left-primer-frac-bound	left-primer-target-sequences	right-primer-start	right-primer-num-primers	right-primer-frac-bound	right-primer-target-sequences	num-guides	total-frac-bound-by-guides	guide-target-sequences	guide-target-sequence-positions
3.5315729313414406	1257	1359	102	1257	1	0.9901719901719902	GGGCAAATACAAAAATGGCTCTTAGCAAAG	1329	2	0.9926289926289926	CCAGCAAATACACCATCCAACGGAGCACAG CCAGCAAATACACTATTCAACGTAGTACAG	3	0.9907862407862408	GTTGAATGATACACTCAACAAAGATCAA TACATTAAATAAGGATCAGCTGCTGTCA TCAAGTTGAATGATACACTCAACAAAGA	{1291} {1300} {1287}
3.708040417140111	16170	16333	163	16170	1	0.9901719901719902	CACTTTATTGCATGCTTCCTTGGCATCATA	16303	2	0.9944717444717445	AGGTGAAGGAGCAGGGAATTTATTATTGCG AGGTGAAGGAGCTGGTAACTTATTATTACG	2	0.9957002457002457	CAGGATGCAAGATCAGTATAGAGTATAT TATATTTTAAAAGATCTTAAAATTAAAG	{16230} {16253}
3.7499337616452864	1257	1400	143	1257	1	0.9901719901719902	GGGCAAATACAAAAATGGCTCTTAGCAAAG	1370	2	0.9914004914004914	GACACTCCCAATTATGATGTGCAAAAACAC GACACTCCTAATTATGATGTGCAGAAACAC	3	0.9907862407862408	GTTGAATGATACACTCAACAAAGATCAA TACATTAAATAAGGATCAGCTGCTGTCA TCAAGTTGAATGATACACTCAACAAAGA	{1291} {1300} {1287}
4.232064373321449	14390	14516	126	14390	2	0.9914004914004914	CATCACCCAGTATCATGTATACAATGGACA CATCGCCAAGTATTATGTTCACAATGGACA	14486	2	0.9914004914004914	CACGTGGTGAGAGAGGACCCACTAAACCAT CTCGTGGTGAAAGAGGACCTACTAAGCCAT	2	1.0	ATAGAAAAATATAATGTTAATGGTTTAA TGGCATAATCATAGAGAAATATAATGTC	{14458} {14448}
4.273043513028185	5300	5435	135	5300	2	0.992014742014742	CCCATGTTCCAATCATCCATGCCAGCAGAT CCTATGTTCCAGTCATCTGTGCCAGCAGAC	5405	2	0.9938574938574939	GTCACGATCAACTCAAGAAGTGCTGTGCTG GTCATGATAAACTCAAGAAGTGCAGTGCTA	2	0.9987714987714987	CAATGTCAATATACTAGTGAAACAAATA TGCTCATAAAAGAACTTGCAAGCATCAA	{5350} {5331}
4.30937293134144	7799	7943	144	7799	2	0.995085995085995	CTGGGGCAAATAACAATGGAGTTGCCAATC CTGGGGCAAATAACCATGGAGTTGCTGATC	7913	2	0.9963144963144963	CAATCAACATGCAGTGCAGTTAGCAAAGGC CAATCGACATGTAGTGCAGTTAGCAGAGGT	2	0.9963144963144963	CTCTGTTTCGCTTCCAGTCAAAACATCA GATCAAGTGCAATCTTCCTAACTCTTGC	{7871} {7833}
4.317909836406473	2157	2278	121	2157	2	0.9944717444717445	GGAGAAGCAGGATTCTACCATATATTGAAC GGAGAAGCTGGTTTCTACCATATATTGAAC	2248	2	0.9993857493857494	GCAATGCAGCAGGTCTAGGCATAATGGGAG GCAATGCTGCTGGCCTAGGCATAATGGGAG	3	0.9969287469287469	ATTGCTGTCATTAACTCAATTTCCTAAC CAATTTCCTCACTTCTCCAGTGTAGTAT CACTATTATCTTTGACTCAATTTCCTCA	{2201} {2217} {2200}
4.358788527362399	14624	14782	158	14624	2	0.9993857493857494	GGGTATATGCATCCATAGACAACAAAGATG GGGTGTATGCATCTATAGATAACAAGGATG	14752	2	0.9987714987714987	CTTACAGTCAGTAGTAGACCATGTGAATTC TTAACAGTCAGTAGTAGACCATGCGAATTC	2	0.9993857493857494	CCACAATATTTAAGTGTTAACTATTTGC TCCACAATATCTAAGTGTCAATTATTTA	{14719} {14718}
4.373275799801319	13195	13400	205	13195	2	0.9932432432432432	AGACTCATGGAAGGTCAAACTCATGCTCAA AGACTTATAGAGGGTCAGACCCATGCTCAA	13370	2	1.0	ACCCAGCTAGTATAAAGAAAGTCCTAAGAG ATCCAGCCAGTATCAAAAAAGTCCTGAGAG	1	0.9944717444717445	GCAGATTATTTGCTAGCATTAAATAGTC	{13225}
4.37547901698314	9866	9999	133	9866	2	0.9926289926289926	TCATAATTACTTTGAATGGCCTCCTCATGC TCATAATTATTTTGAATGGCCACCCCATGC	9969	2	0.9926289926289926	GAAATAAGTGGAGCTGCAGAGTTGGACAGA GAAATAAGTGGAGCTGCTGAACTTGATAGA	3	0.9914004914004914	AACTTTATGTTAAACCGAATACTTAAGT ACTGCTTGTAAGACAAAACTTTATTTTA GTCAATGGACAAGAGCATAGACACTTTG	{9912} {9896} {9938}
4.407268161147406	13752	13926	174	13752	2	0.9926289926289926	AGCTATAGTACATTCAGTGTTCGTGTTGAG GGCTATAGTTCACTCTGTGTTCATACTTAG	13896	2	0.9907862407862408	AACATTGATGAGAGATCCTCAAGCTTTAGG AACATTGATGAGGGATCCACAGGCTTTAGG	2	0.9987714987714987	AACCATGATTTAAAAGATAAACTTCAAG GTCACGATCTACAAGATAAGCTCCAGGA	{13792} {13793}
4.4731266863651715	5235	5435	200	5235	2	0.9969287469287469	CAGCAGCTGTTCAGTACAATGTTCTAGAAA CAGCTGCTGTTCAATACAATGTCCTAGAAA	5405	2	0.9938574938574939	GTCACGATCAACTCAAGAAGTGCTGTGCTG GTCATGATAAACTCAAGAAGTGCAGTGCTA	2	0.9957002457002457	CAATGTCAATATACTAGTGAAACAAATA TTCCAGTCATCTGTGCCAGCAGACTTGC	{5350} {5306}
4.518368161147406	2013	2187	174	2013	2	0.9914004914004914	ATGAATGCCTATGGTGCAGGGCAAGTGATG ATGAATGCCTATGGTTCAGGACAAGTAATG	2157	2	0.9944717444717445	GGAGAAGCAGGATTCTACCATATATTGAAC GGAGAAGCTGGTTTCTACCATATATTGAAC	3	0.9987714987714987	AAAATCAATTAAAAATATTATGTTAGGA ATGGGGAGTTTTAGCCAAATCTGTAAAA TACGGTGGGGGGTCTTAGCAAAATCAGT	{2063} {2048} {2044}
4.534811090344213	9866	10046	180	9866	2	0.9926289926289926	TCATAATTACTTTGAATGGCCTCCTCATGC TCATAATTATTTTGAATGGCCACCCCATGC	10016	2	0.9901719901719902	CGGTGTAGTTGGAGTGCTAGAGAGTTATAT TGGTATAGTTGGAGTGCTAGAGAGTTACAT	3	0.9938574938574939	AACTTTATGTTAAACCGAATACTTAAGT ACTGCTTGTAAGACAAAACTTTATTTTA TTTGTCTGAAATAAGTGGAGCTGCTGAA	{9912} {9896} {9962}
4.655759109049144	2042	2277	235	2042	2	0.9907862407862408	GCTAAGATGGGGAGTTTTAGCCAAATCTGT GTTACGGTGGGGGGTCTTAGCAAAATCAGT	2247	2	0.9993857493857494	GGCAATGCAGCAGGTCTAGGCATAATGGGA GGCAATGCTGCTGGCCTAGGCATAATGGGA	3	0.9957002457002457	AAATATTATGTTAGGACATGCTAGTGTG ATTGCTGTCATTAACTCAATTTCCTAAC CACTATTATCTTTGACTCAATTTCCTCA	{2075} {2201} {2200}
4.678829642842771	13195	13302	107	13195	2	0.9932432432432432	AGACTCATGGAAGGTCAAACTCATGCTCAA AGACTTATAGAGGGTCAGACCCATGCTCAA	13272	3	0.9932432432432432	GTATGCAGGAATAGGCCACAAATTAAAAGG GTATGCAGGCATAGGCCACAAATTAAAAGG GTATGCAGGCATAGGCCATAAGCTTAAGGG	1	0.9944717444717445	GCAGATTATTTGCTAGCATTAAATAGTC	{13225}
4.682121916171137	1257	1507	250	1257	1	0.9901719901719902	GGGCAAATACAAAAATGGCTCTTAGCAAAG	1477	3	0.9969287469287469	TGCGATGTCTAGGTTAGGAAGAGAAGACAC TGCTATGTCCAGGTTAGGAAGGGAAGACAC TGCTATGTCTAGATTAGGAAGAGAAGACAC	3	0.9907862407862408	GTTGAATGATACACTCAACAAAGATCAA TACATTAAATAAGGATCAGCTGCTGTCA TCAAGTTGAATGATACACTCAACAAAGA	{1291} {1300} {1287}
4.809764845367943	14672	14782	110	14672	3	0.9963144963144963	GCATAGGAACCCTTGGGTTAACATATGAAA GCATAGGAACTCTTGGGTTAACATATGAGA GTACTGGAACACTTGGACTGTCATATGAAA	14752	2	0.9987714987714987	CTTACAGTCAGTAGTAGACCATGTGAATTC TTAACAGTCAGTAGTAGACCATGCGAATTC	2	0.9993857493857494	CCACAATATTTAAGTGTTAACTATTTGC TCCACAATATCTAAGTGTCAATTATTTA	{14719} {14718}
4.907778667660241	2013	2121	108	2013	2	0.9914004914004914	ATGAATGCCTATGGTGCAGGGCAAGTGATG ATGAATGCCTATGGTTCAGGACAAGTAATG	2091	3	0.9901719901719902	CACGCTAGTGTACAAGCAGAAATGGAACAA CATGCTAGTGTCCAAGCAGAAATGGAGCAA CATGCTAGTGTGCAAGCAGAAATGGAACAA	3	0.9987714987714987	AAAATCAATTAAAAATATTATGTTAGGA ATGGGGAGTTTTAGCCAAATCTGTAAAA TACGGTGGGGGGTCTTAGCAAAATCAGT	{2063} {2048} {2044}
5.861133761645286	16331	16557	226	16331	2	0.9938574938574939	CGTACAGTAGTGGAACTTCATCCTGATATA CGTACGGTAGTAGAACTTCATCCTGACATA	16527	4	0.9938574938574939	CAGAACCTATTAGCATCTTTGTCTGCGATG CAGAACCTATTAGTATCTTTGTCTGCGATG CAGAACCTGTTAGTATCTTTGTTTGCGATG CTGAACCTATCAGTCTTTTTGTCTGTGATG	2	0.9987714987714987	ATTATGGTGAAAATTTGACCATTCCTGC ATTATGGTGAGAATTTAACCATCCCTGC	{16449} {16449}
