cost	target-start	target-end	target-length	left-primer-start	left-primer-num-primers	left-primer-frac-bound	left-primer-target-sequences	right-primer-start	right-primer-num-primers	right-primer-frac-bound	right-primer-target-sequences	num-guides	total-frac-bound-by-guides	guide-target-sequences	guide-target-sequence-positions
4.347985018119718	9475	9602	127	9475	2	0.9936305732484076	TACAATGATATGTGCATACAGACATGCACC TACAATGATATGTGCCTATAGACATGCACC	9572	2	0.9936305732484076	ATGGGAGGGATTGAAGGGTGGTGCCAGAAG ATGGGTGGTATTGAAGGATGGTGTCAAAAA	3	1.0	ATAGACAAAATAGAAGAGCAAAGTGGGT GGAGTATGATATAGACAAAATACAAGAG TATAGATAAGATAGAAGAGCAAAGTGGT	{9530} {9520} {9529}
4.415595040691432	4850	5027	177	4850	2	0.9936305732484076	GCAAATATGAAGTACGGGGCAAGTGCAACA GCAAATATGAAGTGCGGGGCAAATGCAATA	4997	2	0.9936305732484076	TATCAATAATATCAGGCGCAGGCAGAGAAG TGTCAATAATATCAGGAGCAGGTAGAGAAG	2	0.9936305732484076	AAACTATCTATTAAATCAGCTTTTAAGG TAGATACTTATTAATAAGATCAAATTAT	{4947} {4926}
4.415595040691432	11394	11571	177	11394	2	1.0	GCTGCGGAATTAGTATAATGAGTGTTGTAG GCTGTGGAATTAGCATAATGAGTGTAGTAG	11541	2	0.9936305732484076	TAACCTCTGATCAACACATCTTCAGTCCTG TAACTTCTGATCAACATATCTTCAGTCCGG	2	0.9936305732484076	AACTGGTAGAAGCCCAAAACAATTAGCC GGTAGGAGTCCAAAACAGTTAGTTTTAA	{11431} {11435}
4.46660063353398	3663	3820	157	3663	2	0.9936305732484076	GGCCGTTAGCTTCAGTCAATTCAACAGAAG GGCTGTCAGCTTCAGTCAATTCAACAGAAG	3790	2	0.9936305732484076	TCATACATGCCAACATCTGCAGGACAGATA TCCAACATGCCGACATCTGCAGGACAAATA	3	1.0	GACAGATGCTGAACTAGCCAGGGCCGTT GCAGGGATAACACCAGCAATATCATTGG TTCCTAAATGTTGTGCGGCAGTTTTCAG	{3762} {3727} {3694}
4.509864730403719	11394	11611	217	11394	2	1.0	GCTGCGGAATTAGTATAATGAGTGTTGTAG GCTGTGGAATTAGCATAATGAGTGTAGTAG	11581	2	0.9936305732484076	CATATTAACACTAGGGAAGATGCTTATGCC TATGTTAACACTAGGGAAAATGCTCATGCC	2	0.9936305732484076	AACTGGTAGAAGCCCAAAACAATTAGCC GGTAGGAGTCCAAAACAGTTAGTTTTAA	{11431} {11435}
4.531572931341441	4850	5078	228	4850	2	0.9936305732484076	GCAAATATGAAGTACGGGGCAAGTGCAACA GCAAATATGAAGTGCGGGGCAAATGCAATA	5048	2	0.9936305732484076	TAGGTTCCACCAATGTGGTTCAAGGTTATA TTGGTTCTACTAATGTGGTTCAAGGGTACA	2	0.9936305732484076	AAACTATCTATTAAATCAGCTTTTAAGG TAGATACTTATTAATAAGATCAAATTAT	{4947} {4926}
4.560735466635868	5226	5378	152	5226	3	1.0	CTATATGGAGATGAGCAAAACTCCTGCATC TTACATGGAGATGAGCAAAACTCCCGCATC TTACATGGAGATGAGCAAGACTCCTGCCTC	5348	1	0.9936305732484076	CTTCATATGCCCTGCAAGACAGTGAAAGCA	4	1.0	ACCAAGAGAAAAACTGAAGAAATTAGCG ATAATTGACTTATCAGCAGGTGCTGACA GAAAAAATTAGCGAAATTAATAATTGAT GAAGAAATTAGCAAGATTAATAATTGAT	{5280} {5314} {5295} {5295}
4.732064730403719	2720	2937	217	2720	2	0.9936305732484076	AGCCACTGTTGAAGCTGCAATAAGCAGTGA AGCTACTGTTGAAGCTGCTATAAGCAGTGA	2907	2	1.0	AAAATATGCAAGACTTGGAGCCATCAAGGG AGGATCTGCAAGAGCTGGAGTCACCAAGGA	4	1.0	AGCATTAACACAAGCCAAAATTGCACCC AGCCTTGACACAAGCTAAGATTGCACCC AGCTCTAACACAGGCCAAAATTGCACCT CTAAAGGCATATTCAAGAAGCTTGGAGC	{2759} {2759} {2759} {2824}
4.761316028494806	1844	1990	146	1844	2	0.9936305732484076	AAGAACACTCAACATTGCTACAGCAGGACC TCGTACACTTAACATTGCAACAGCAGGACC	1960	2	1.0	AAGCAGCAGAAATGATGGAAGAGGAAATGA AAGCAGCTGAAATGATGGAAGAAGAGATGA	6	1.0	GAGGAACTAATAGCAGACATAATAAAAG GCAGAAATAATAAAAGAAGCCAAGGGAA GCAGACATAATAAAAGAGGCCAAGGGAA TGGCATAAGAGAAGAACTAATAGCAGAG TGGTATAAGAGAAGAACTAATAGCAGAG TGGTATGAGAGAAGAACTAATAGCAGAG	{1920} {1932} {1932} {1910} {1910} {1910}
4.788119948987033	3441	3688	247	3441	2	0.9936305732484076	AGCAGCAGTCACAGCAGGCATTGCAATAGC AGCTGCAGTTACAGCAGGTGTTGCAATTGC	3658	2	0.9936305732484076	AAAATGGCCGTTAGCTTCAGTCAATTCAAC AAGATGGCTGTCAGCTTCAGTCAATTCAAC	4	1.0	AGCAGTAACTACATTGGGGAATGGAGTT CTGAAAGATTTTGTGAGCAAGAATTTAA GAGTGAGGTGAATGCAATTAAAGGTGCT TTGTGAGCAAAAACCTGACTAGTGCAAT	{3534} {3589} {3489} {3599}
4.803288527362399	11394	11503	109	11394	2	1.0	GCTGCGGAATTAGTATAATGAGTGTTGTAG GCTGTGGAATTAGCATAATGAGTGTAGTAG	11473	3	1.0	AGAAGAAATAGACATTATGCCACCACCAGT AGAAGAGATAGATATTATGCCTCCTCCTGT AGAGGAAATAGACATTATGCCACCACCAGT	2	0.9936305732484076	AACTGGTAGAAGCCCAAAACAATTAGCC GGTAGGAGTCCAAAACAGTTAGTTTTAA	{11431} {11435}
4.868211090344213	11491	11611	120	11491	3	0.9936305732484076	GCCACCACCAGTGTTTCAAGGGAAATTCAA GCCTCCACCAGTGTTTCAAGGAAAATTCAA GCCTCCTCCTGTATTTCAAGGAAAATTCAA	11581	2	0.9936305732484076	CATATTAACACTAGGGAAGATGCTTATGCC TATGTTAACACTAGGGAAAATGCTCATGCC	2	1.0	ACTAGTTGATAAAATAACCTCCGATCAA TAGTTGATAAAATAACCTCTGATCAACA	{11527} {11529}
4.913014134296109	2280	2409	129	2280	3	0.9936305732484076	CTGCCAGCAAGTTTGACAATATGGTTTCCT TTACCTGCAAGCCTAACAATATGGTTCCCT TTACCTGCGAGCCTAACTATATGGTTCCCT	2379	2	0.9936305732484076	TATGCTGCATCACAAAGTGGTCCAATACTA TATGCTGCATCACAGAATGGTCCAATACTC	2	1.0	CTATTCCAAGCCAACACACCACCAGCGG TTTCAGGCCAATACACCACCAGCAGTTC	{2310} {2313}
4.933437705370951	11758	11870	112	11758	3	0.9936305732484076	CAAGAAAGACTGGGGTGACGGGTTTATATC TAGGAAAGACTGGGGTGATGGGTTCATATC TAGGAAAGATTGGGGTGATGGGTTCATCTC	11840	2	0.9936305732484076	CTTTTATGTAGTTGGGGATCCCAAGGGAAA CTTTTATGTAGTTGGGGATCTCAAGGAAAG	3	1.0	CAAGGTATTTCTATGTGTATTTAAAACC TCATGGATTTCAAGATTTTTCTATGTGT TGGACTTCAAAATATTCCTATGTGTCTT	{11809} {11799} {11802}
4.964414670640964	3325	3466	141	3325	3	0.9936305732484076	GCACTAAGAGAGCTCAAAACAGTTTCTGCT GCTCTAAGAGAACTCAAAACAGTTTCTGCT GCTTTAAGGGAACTCAAAACAGTCTCTGCT	3436	2	0.9936305732484076	ACAGCAGCAGCAGTCACAGCAGGCATTGCA ACAGCAGCTGCAGTTACAGCAGGTGTTGCA	2	1.0	CAAGAGAGGAACAAATTGAGAATCCCAG GTTAGCGAGAGAAGAACAAATTGAAAAT	{3365} {3360}
4.989822420167964	4317	4439	122	4317	2	0.9936305732484076	CTCATACATAACTAACCAGGATGCAGACAC CTCTTATATAACCAACCAAGATGCAGACAC	4409	3	0.9936305732484076	AAGGAAGGCCAGTGTCAAGCAGCTTTGATC AAGGCAGACCAGTGTCAAGCAGCTTTGATC AAGGGAGACCAGTTTCAAGCAGTTTTGATC	3	1.0	AAAGTTGAGGGTGAACAGCATGTTATAA AGCAAAGTTGAAGGTGAACAGCATGTAA TAAGCAAAGTTGAAGGCGAACAGCATGT	{4381} {4378} {4376}
5.026428706359164	11584	11783	199	11584	2	1.0	ATTAACACTAGGGAAGATGCTTATGCCTAC GTTAACACTAGGGAAAATGCTCATGCCCAC	11753	3	0.9936305732484076	ATCTTCAGGAAAGACTGGGGCGATGGGTTC ATCTTTAGGAAAGATTGGGGTGATGGGTTC ATTTTCAAGAAAGACTGGGGTGACGGGTTT	1	1.0	TGTGGGATATTAACAGAACAATGCATAG	{11717}
5.102085705661208	11547	11783	236	11547	2	0.9936305732484076	CTGATCAACACATCTTCAGTCCTGACAAAA CTGATCAACATATCTTCAGTCCGGACAAAA	11753	3	0.9936305732484076	ATCTTCAGGAAAGACTGGGGCGATGGGTTC ATCTTTAGGAAAGATTGGGGTGATGGGTTC ATTTTCAAGAAAGACTGGGGTGACGGGTTT	1	1.0	TGTGGGATATTAACAGAACAATGCATAG	{11717}
5.105707968360734	11584	11733	149	11584	2	1.0	ATTAACACTAGGGAAGATGCTTATGCCTAC GTTAACACTAGGGAAAATGCTCATGCCCAC	11703	3	0.9936305732484076	TAGCATGTCATTGGTGTGGGATATTAACAG TGGCATGCCATTGGTGTGGGATACTAACAG TTGCATGCCACTGGTGTGGAATATTAACAG	3	1.0	ATAAAAGGTCAGAAAACAGATCAGTTCT CATAAAAGGTCAAAAAACTGATCAGTTC GTTCTTAAATAAGAGAGAAAATTATTTC	{11615} {11614} {11638}
5.11283196905215	12076	12227	151	12076	3	1.0	TGAAATACCTTGGATTGTCAATGCCGAAGG TGAAGTACCCTGGATTGTCAATGCTGAAGG TGAGGTACCTTGGATTGTCAATGCTGAAGG	12197	2	0.9936305732484076	ATGGCACATGCTCTCACACGATTAATCAGA ATGGCACATGCTCTTACACGATTAATTAGG	3	1.0	AACAAAGCTTATTTTTGAGAATAACTGT AGTTGAAATTAAACCAATCAAAATTTAT TGAGATCAAGTCAATTAAAATCTATTTG	{12153} {12112} {12115}
